ⵉⵍⵎⵎⴰ ⵏⴳ ⵜ ⴳ ⵓⴹⴱⵚⵉⵍ ⵍⵍⵉ ⵔⴰⴷ ⴷ ⵏⵙⵔⵙ	بعدها نصفه في طبق التقديم
ⵉⵙⵙⵏⵜⵉ ⴰⵙⵎⵔⵙ ⵏⵏⵙ ⴳ ⵜⵎⵀⵍⵉⵏ ⵏ ⵓⵙⵖⵓⴷⵓ ⴳ ⵓⵙⴳⴳⵯⴰⵙ ⵏ 1980	وبدأ استخدامها في عمليات التجميل سنة 1980
ⴷⴰ ⵉⵙⵙⵎⵔⴰⵙ ⵎⴰⵢⴷ ⵉⴳⴰⵏ ⴰⵙⵍⵉⵥⵕⵉ ⴷ ⵡⵓⴼⵔⵉⵢ	يستخدم ما هو سمعي وبصري وحسي

ⵔⴰⴷ ⴰⵡⵏ ⵙⵎⵓⵜⵜⴳⵖ ⴰⵙⵙ ⴰⴷ ⵉⵎⴳⵔⵉⵙⵏ ⵙ ⴽⴰⵡⴽⴰⵡ ⴷ ⵛⵛⴽⵯⵍⴰⵟ	سأعد لكم اليوم مثلجات بالفستق والشوكولاتة
ⴷⴰ ⴰⵖ ⴰⴽⴽⴰⵏ ⵜⴰⴱⵔⴰⵜ ⵎⴰⵙ ⵉⵍⵍⴰ ⵓⵎⵢⴰⵙ	تعطينا رسالة على وجود التوازن
ⵉⵎⴽⵍⵍⵉ ⵜⵥⵕⵕⴰⵎ ⴽⵔⵉⵎⴰ ⵜⵔⵖⴰ	كما ترون الكريمة أصبحت ساخنة
ⵍⵍⵉ ⴽⵏ ⵉⵜⵜⵉⵔⵉⵏ ⴱⴰⵀⵔⴰ	التي تحبكم كثيرًا
ⵢⴰⵀ, ⵉⴳⴰ ⴰⴷⵉⴽⵓⵔ ⵏ ⵡⴰⵏⵉⵔ ⵏ ⵄⴰⵍⴰ ⴷⴷⵉⵏ	نعم هو ديكور مصباح علاء الدين
ⵎⴰⵛⴰ ⵉⴳ ⵏⵓⵔⵔⵉ ⵙ ⵓⵎⵣⵔⵓⵢ	و لكن بالعودة للتاريخ
ⵢⵉⵍⵉ ⵎⴰ ⵉⵜⵜⴰⵡⵏ ⵉⵙ ⵉⵙⴽⵔ ⵜⴰⵣⵓⵍⵜ	وهناك من ينسى إن قام بالتحية
ⵍⵍⴰⵏⵜ ⴳ ⵎⵏⵏⴰⵡ ⵉⴽⵯⵍⴰⵏ	متوفرة في عدة ألوان
ⵢⴰⵀ ⵉⵎⴽⵍⵍⵉ ⴳⵉⵙ ⵏⵙⵙⵎⵔⵙ ⵊⵉⵍⴰⵜⵉⵏ	نعم كما إستخدمنا فيها الجيلاتين
ⴰⵏⵎⵓⵇⵇⴰⵔ ⵏⵏⵖ ⴳ ⵜⴳⵟⵟⵓⵎⵜ ⵢⴰⴹⵏⵉⵏ	وموعدنا في فقرة أخرى
ⴰⵔ ⵖⵉⴷ ⵥⵕⵕⴰⵖ ⵓⵍⴰ ⵜⴰⵎⵎⵏⵜ	أرى هنا أيضا العسل
ⵉⵎⴰⵏⵏⴰⵢⵏ ⵏⵏⵖ ⵉⵥⵉⵍⵏ ⵏⵍⴽⵎ ⵜⵉⴳⵉⵔⴰ ⵏ ⵜⴳⵟⵟⵓⵎⵜ ⵏ ⵓⵖⵓⴷⵓ	مشاهدينا الأعزاء بلغنا نهاية فقرة جمال
ⵏⴰⴼ ⵏⵏ ⵖⵓⵔⵙⵏ ⵖⵙ 300 ⵎⴳ ⵏ ⵓⴽⴰⵍⵙⵢⵓⵎ	فنجد لديهم فقط 300 ملغ من الكالسيوم
ⴳ ⵜⵣⵡⵉⵔⵉ, ⵎⴰⵢⴷ ⵙⵉⵙ ⵏⵡⴰⴷⵙ?	في البداية، ما المقصود بها؟
ⵣⵓⵏ ⴷ ⴳ ⵓⴷⵖⴰⵔ ⵏⵏⵙⵏ, ⵏⵖ ⴳ ⵓⴷⵖⴰⵔ ⵢⴰⴹⵏⵉⵏ	سواء في مكانها أو في مكان آخر
ⵜⵜⵓⵙⴽⴰⵔⵏ ⵙⴳ ⵜⵎⵜⵜⴰ ⵉⵅⴰⵜⵔⵏ ⴷⴰⵔⵉ	مصنوعة من مادة مهمة بالنسبة لي
ⵉⴳ ⴷ ⴷⵉⵙ ⵓⵔ ⵜⵓⵛⴽⵉ ⴷⴰ ⵜ ⵜⵙⵎⵎⵜⴰⵔⴷ ⵙ ⵜⴰⵢⵢⴰⴹ	إن كانت غير مناسبة تنصحه بغيرها
ⵉⵍⵍⴰ ⵓⴽⵍⵓ ⵉⵥⵍⵉⵏ ⵙ ⵜⵙⵍⵉⵜ ⴷ ⵉⵜⵜⵓⵙⵙⴰⵏ	هناك لون خاص بالعروس وهو معروف
ⴷ ⵜⵣⴰⵢⴽⵓⵜⵉⵏ ⵙ ⵢⴰⵜ ⵜⴽⴽⵍⵜ	وتقليدية في نفس الآن
ⵏⵥⴹⴰⵕ ⴰⴷ ⵏⴰⴼ ⴽⵔⴰ ⵏ ⵜⴽⴽⴰⵍ ⴰⵔⴳⴰⵣ ⵏⵉⵜ ⴰⵢⴷ ⵉⵙⵎⵓⵜⵜⵓⴳⵏ ⴰⵖⵓⵊⵊⵔ ⵉ ⵡⴰⵔⵔⴰⵡⵏ ⵏⵏⵙ	يمكن أن نجد أحياننا الزوج هو من يحضر وجبة الفطور لأولاده
ⵉⴳⴰ ⵓⵙⴱⴷⴷⴰ ⵏ ⵡⵓⵜⵛⵉ ⵙⴳ ⵓⵏⵇⵇⵔ ⵏ ⵜⴰⴼⵓⴽⵜ ⴰⵔ ⴰⵖⵍⵍⵓⵢ ⵏⵏⵙ	هو للامتناع عن الأكل من شروق الشمس إلى غروبها
ⵓⵔ ⵔⵉⵖ ⴰⴷ ⵖⴰⵎⴰⵖ ⴳ ⵢⴰⵏ ⵓⵙⵡⵉⵔ	لا أريد البقاء في نفس المستوى
ⴰⵛⴽⵓ ⴰⵏⵎⴳⴰⵍ ⵏ ⵜⵕⵥⵉ ⴳⵉⵙ ⴰⵔⴰⵢ ⴷ ⵜⵥⴹⴰⵕⵜ ⵏ ⵓⵥⵉⴹⵕ	لأن المضاد للكسر فيه حماية وقدرة على التحمل
ⵉⵍⵎⵎⴰ ⵜⴰⵄⵎⵎⴰⵔⵉⵜ ⴷ ⵍⵀⴹⵕⵜ ⴷ ⵜⵙⵓⵜⵍⵜ	ثم العمارية والتهضيرة والدورة
ⵍⵍⴰⵏ ⵡⴰⵏⴰⵡⵏ ⵢⴰⴹⵏⵉⵏ ⵙⴳ ⵡⴰⵣⵣⴰⵏⵏ ⵎⵉ ⵉⴳⴳⵓⵜ ⵓⵎⵓⵙⵙⵓ	هناك نوع آخر من الأطفال حركين
ⵉⴳ ⵓⵔ ⴷⴰⵔⴽ ⵜⵍⵍⵉ ⵜⵖⴰⵍⵉⵜ ⵉⴼⵓⵍⴽⵉⵏ ⴳ ⵕⴱⴱⵉ ⵣⵡⴰⵔ	إذا إنعدم لديك حسن الظن بالله أولا
ⵍⵍⴰⵏⵜ ⵙⵏⴰⵜ ⵜⵖⴰⵡⵙⵉⵡⵉⵏ, ⵜⴰⵎⵣⵡⴰⵔⵓⵜ ⵜⴳⴰ ⴰⵏⴳⵔⴰⵡ ⴰⵎⵙⴰⴷⵓⵔ	هنالك أمرين، أولهما الحمية
ⵉⵙⵙⴱⵖⵙ ⵉⵢⵉ, ⵢⵉⵏⵉ ⵎⴰⵙ ⵉⴽⵜⵉ ⴷ ⵎⴰⵙ ⴷ ⵉⵎⵎⵉⵙ ⴷⴰⵔⵙ ⵣⵓⵏ ⴷ ⵜⵉⴼⵉⵍⵉⵜ ⴰⴷ	شجعني، و قال أنه يتذكر أن والدته كانت لديها مثل هذه القلادة
ⵏⴳ ⵏⵏ ⴰⵣⴳⵏ ⵏⴰⵊⵊ ⴰⵢⵍⵍⵉ ⴷ ⵉⵖⴰⵎⴰⵏ	نضع النصف ونترك الباقي
ⴰⵛⴽⵓ ⵜⴰⵎⵙⵙⵓⵔⵜ ⴰⵢⴷ ⵢⵓⵙⵉⵏ ⵜⴰⵎⵙⵜⴳⴳⴰⵔⵜ	لأن الشركة هي من تتحمل المسؤولية
ⵉⴳⵔ ⴰⵎⵖⵔⴰⴱⵉ ⵉⵎⵢⴰⵏⴰⵡ, ⴷ ⴽⵓ ⵜⴰⵎⵏⴰⴹⵜ	المجال المغربي متعدد، وكل منطقة
ⴷ ⵔⴰⴷ ⵜⵕⵥⵎ ⵉ ⵉⵙⵎⴰⵎⵏ ⵏⵏⴰ ⵔⴰⴷ ⵜ ⵉⴽⵯⵎⵉⵏ ⵓⴳⴳⴰⵔ	وستفرز أحماضا ستضره أكثر
ⴰⵙⵓⵊⵊⵉ ⵏ ⵉⵎⵓⴹⴰⵏ ⵏ ⵓⵙⴽⴽⵯⴰⵔ ⵉⴱⴷⴷ ⵖⴼ ⵡⴰⴷⴷⴰⴷ ⵏ ⵓⴹⴰⵕ	تعتمد معالجة مرضى السكري على حالة القدم
ⵍⵍⵉⴳ ⵎⵎⵓⵜⵜⵉⵖ ⵙ ⵜⵎⴷⵉⵏⵜ ⴽⵛⵎⵖ ⵙ ⵜⵔⴰⴱⴱⵓⵜ ⵏ ⵓⵎⵣⴳⵓⵏ	عندما إنتقلت إلى المدينة إنضممت لفرقة المسرح
ⵉⴽⵙⵏ ⵉⵖⴼ ⵏⵏⵙ ⴷ ⵉⵎⴰⵔⴰⵡⵏ ⵏⵏⵙ	يكره ذاته وأهله
ⵙ ⵉⵣⵡⵉⵔ ⵉⴼⵓⵍⴽⵉ ⴰⴷ ⵏⴰⵔⵎ	أولا من الجيد أن نخوض التجربة
ⴰⵡⴷ ⴰⵙⴰⵎⵎⵖ ⴷⴰ ⵜ ⵏⵙⵙⴰⵖ ⵙⴳ ⵜⵎⵙⵙⵓⵔⵉⵏ	حتى الزجاج نشتريه من الشركات
ⵏⵙⴰⵡⵍ ⵖⴼ ⵜⵖⴰⵡⵙⵉⵡⵉⵏ ⵜⵓⴷⵎⴰⵡⴰⵏⵉⵏ ⵍⵍⵉ ⵓⵔ ⵉⵜⵜⴰⵊⵊⴰⵏ ⵜⴰⴼⵍⵙⵉⵎⴰⵏⵜ	تحدثنا عن الأمور الشخصية التي تعيق الثقة بالنفس
ⵣⵓⵏ ⵉⴳⴰ ⴰⴽⵓⵎⵉⴷⵉ ⵏⵖ ⴰⴹⵕⴰⵎⵉ	سواء كان كوميديا أو درامياً
ⵡⵉⵏⵏⴰ ⵉⵣⵣⴷⵉⴳⵏ ⵉⴷⴰⵎⵎⵏ ⴷⴰ ⵜⵏ ⵉⵜⵜⴰⵖ ⵡⴰⵟⵟⴰⵏ ⴰⴷ	من يقومون بتصفية الدم يصابون بهذا المرض
ⴷ ⴷⴰ ⵉⵜⵜⵉⵏⵉ ⵎⴰⵙ ⵉⵙⵡⴰ ⴰⴽⵯⴼⴰⵢ ⴰⵎⵙⴰⵔⵉ ⵉⵍⵎⵎⴰ ⵉⵙⵔⴳ ⴰⵙ ⴰⵏⴳⴰⵥ	حيث يقول أنه شرب حليبا نيئا فأصابه بألم
ⵔⴰⴷ ⵙⵎⵓⵜⵜⴳⵖ ⵢⴰⵏ ⵓⴼⵛⴽⵓ	سأحضر إناءا
ⵣⵓⵏ ⴷ ⴰⴼⴳⴰⵏ ⵢⴰⵇⵇⵔⴰⵏ ⴱⴰⵀⵔⴰ ⴰⴼⴰⴷ ⴰⴷ ⵉⵎⵓⵔⵙ ⴷ ⴰⴷ ⵉⵚⴽⵓ ⵉⵎⴰⵍ ⵏⵏⵙ	مثل شخص يدرس كثيرا لكي ينجح ويبني مستقبله
ⴷ ⵔⴰⴷ ⴷⴰⵔⵙ ⵢⵉⵍⵉ ⵓⴷⵖⴰⵔ ⵏⵏⵙ ⵖⵉⵏⵏⴰ ⴳ ⵜⵍⵍⴰ	وستكون لها مكانتها حيثما حلت
ⵏⵣⵣⵔⵉ ⴷⵉⵎ ⵜⵉⵣⵉ ⵉⴼⵊⵊⵉⵊⵏ	أمضينا معك وقتا ممتعا
ⴷ ⵓⵔ ⵉⵜⵜⵓⵙⵎⵔⵙ ⵉⵎⴽⵍⵍⵉ ⴷ ⵉⵇⵇⴰⵏⵏ	ولم يستعمل كما يجب
ⴽⴽⵉⵖ ⵜⵜ ⵉⵏⵏ ⴷⴰ ⵙⵙⴼⵍⵉⴷⵖ ⵉ ⵄⵎⵎⵓⵔⵉ ⵎⴱⴰⵔⴽ	كنت أستمع لعموري مبارك
ⴰⵥⵟⵟⴰ ⴰⴷ ⴷⴰ ⴰⵖ ⵉⵜⵜⴰⵡⵙ ⴳ ⵜⵉⵣⵉ ⵏ ⵓⵎⵏⴰⵍⴰ ⵏ ⴽⵔⴰ ⵏ ⵓⵎⵓⴽⵔⵉⵙ	هذه الهيكلة تساعدنا في حال مواجهة مشكل
ⵉⵍⵎⵎⴰ ⵙⵎⴰⵙⵙⵖ ⵓⵔⴽⵉⵙ	تم أحرك الخليط
ⵣⵉⴽⴽ, ⵉⴳ ⵜⵜ ⵜⵓⵔⵉⴷ ⵙ ⵓⴼⵓⵙ, ⴷⴰ ⵥⵕⵕⴰⵏ ⵜⴰⵖⴰⵔⴰⵙⵜ ⵏⵏⴽ ⴷ ⵜⵉⵔⵔⴰ ⵏⵏⴽ	سابقا، حين تكتبها باليد يقفون على أسلوبك وخطك
ⴰⵔ ⴰⵏⵎⵓⵇⵇⴰⵔ ⵏⵏⵖ ⴰⵎⴰⵢⵏⵓ ⵉⴳ ⵜ ⵉⵏⵏⴰ ⵕⴱⴱⵉ	موعدنا سيتجدد في لقاء آخر إن شاء الله
ⵖⴰⵎⴰⵢⴰⵜ ⴳ ⵡⴰⴼⵓⵍⴽⵉ	دمتم بخير
ⴰⵛⴽⵓ ⵜⵓⴷⵔⵜ ⴷⴰ ⵜⴻⵜⵜⵏⴼⵍⴰⵢ, ⵢⵉⵍⵉ ⴼⵍⵍⴰⵖ ⴰⴷ ⵜⵜ ⵏⴹⴼⵕ	فالحياة تتطور وعلينا مواكبتها
ⴰⵛⴽⵓ "ⵙⵏⴰⴱ" ⴷⴰ ⵉⵙⵙⵓⵜⵓⵔ ⵜⵓⴽⴽⵙⴰ ⵏⵏⵙ ⴷⴰⵔ ⵡⵓⵜⵛⵉ ⴷ ⵓⵙⵓⵔⵔⵉ ⵏⵏⵙ ⴹⴰⵕⴰⵜ ⵏ ⵓⵙⵉⵣⴷⴳ ⵏⵏⵙ	لأن ’’سناب‘‘ يتطلب إزالته أثناء الأكل وإعادته بعد تنظيفه
ⵉⵙ ⴷⴰ ⵜⵜⴰⴼⴰⵏⵜ ⵜⴼⵉⵍⵉⵏ ⵏⵏⵎ ⵜⵓⵜⵜⵔⴰ?	هل تلقى لوحاتك إقبالا؟
ⴷⴰ ⵜⵏ ⵉⵜⵜⴰⵖ ⴽⵔⴰ ⵏ ⵜⴽⴽⴰⵍ ⴳ ⵓⴼⵓⴷ	يصابون به أحيانا في الركبة
ⴰⵢⵍⵍⵉ ⵉⵀⵎⵎⴰⵏ, ⵉⴳⴰ ⵜ ⵎⴰⵏⵎⴽ ⵜ ⵏⵣⵔⴰⵢ ⵙ ⵜⴼⵔⴽⵜ ⵢⴰⴹⵏⵉⵏ	الأهم هو كيف نجتازها إلى مرحلة أخرى
ⵉⵎⵎⴰⵜⵜⵉ ⵓⵎⵙⵉⵖⵉ	فتنتقل العدوى
ⵎⵏⵏⴰⵡⵜ ⵜⵖⴰⵡⵙⵉⵡⵉⵏ ⴰ ⵉⵍⵍⴰⵏ?	كم من الأشياء توجد؟
ⴷ ⵓⵍⴰ ⵜⴰⵡⵓⵔⵉ, ⵉⵇⵇⴰⵏ ⴷ ⴰⴷ ⵜⵉⵍⵉ ⴷⴰⵔ ⵓⴼⴳⴰⵏ ⵜⴰⵡⵓⵔⵉ ⴷ ⵓⵏⴽⵛⵓⵎ	وكذلك العمل، فلابد أن يكون للشخص عمل ومدخول
ⵎⵇⵇⴰⵔ ⴷ ⵉⴽⴽⴰ ⵡⴰⵡⴰⵍ ⴷⴰⵔ ⵓⵎⴰⵙⵙⴰⵏ	ولو كان مصدر القول من عالم
ⵓⵔ ⴷⴰ ⵉⴼⵜⵜⵓ ⵎⵇⵇⴰⵔ ⵏⵙⵙⵎⵔⵙ ⵏ ⵉⵎⵙⴷⴽⴰⵜⵏ ⵏ ⵓⵏⴳⴰⵥ	لا يختفي رغم تناول مسكنات الألم
ⵉ ⵜⴼⵔⵓⵅⵜ ⵏⵖ ⴰⴼⵔⵓⵅ	سواء للفتاة أو الولد
ⴷⴰ ⵜⵙⵙⵎⵔⴰⵙⵎ ⴰⵍⵡⵡⴰⵜ ⵀⵍⵍⵉ?	تستخدمون المطاط فقط؟
ⴽⵓⴷⵏⵏⴰ ⵉⵎⵇⵇⵓⵔ ⵔⴰⴷ ⵉⵊⵊⴰⵡⵏ ⴰⵣⴰⵍⵏ ⴰⴷ	عندما يكبر سيتشبع بهذه القيم
ⵜⵣⴷⵔ ⵖⴼ ⵜⵎⵉⵊⵊⵉⵜⵉⵏ ⵜⵉⵙⴰⵍⴰⵏⵉⵏ	منخفضة عن العطور الأصلية
ⵎⴰⵛⵛ ⵢⵓⴼ ⴰⴷ ⵢⵉⵎⵢⵓⵔ ⵓⵔⴳⴰⵣ ⴰⴷ ⵜⵜ ⵉⵙⵏⵉⵎⵎⵉⵔ	و لكن يفضل أن يتعود الرجل على شكرها
ⵏⵜⵜⴰ ⴷⴰ ⴽⴰ ⵉⵙⴽⵔⴽⵉⵙ ⴰⴼⴰⴷ ⴰⴷ ⵢⴰⵎⵥ ⵜⵉⵍⵉⴼⵓⵏ	هو فقط يحتال لكي يحصل على الهاتف
ⵏⴽⴽⵏⵉ ⵏⵥⵍⵉ ⵙ ⵓⵙⵖⵉⵡⵙ ⴷ ⵡⴰⵏⴰⵡ ⵏ ⵜⵉⴼⵙⵜ	فنحن نتكلف بالتصميم وبنوعية الثوب
ⵉⴳⴳⵓⵜ ⵎⴰ ⵉⴽⵚⵓⴹⵏ ⴰⵙⵎⵔⵙ ⵏ ⵚⵚⴰⴱⵓⵏ	الكثير يخاف من إستعمال الصابون
ⴰⵡⵜⴰⵢ ⴷ ⴰⵡⴷ ⵜⵉⵥⴹⴰⵕⵉⵏ ⵏⵏⵙ	السن وقدراته أيضا
ⵏⴽⴽⵏⵉ ⵓⵔ ⵏⴽⵚⵓⴹ ⵖⴼ ⵓⴳⴷⵓⴷ	فنحن لا نخشى على الجمهور
ⵣⵓⵏ ⴷ ⵎⵉⵜ?	مثل ماذا؟
ⵉⵎⴽⵍⵍⵉ ⵏⵥⵕⵕⴰ ⴽⵢⵢⵉ ⵓⵔ ⴷⴰ ⵜⵙⵎⵓⵜⵜⵓⴳⴷ ⵏⵖ ⵜⵙⴽⵔⴷ ⵜⵓⵏⵏⵓⵏⵜ ⴰⴷ ⵀⵍⵍⵉ	كما نرى أنت لا تُدرب أو تمارس هذه الرياضة فقط
ⵜⵉⵣⵉ ⵏ ⵜⵙⵔⴰⴳⵜ ⵏ ⵡⴰⴽⵓⴷ	مدة ساعة من الزمن
ⵏⵥⴹⴰⵕ ⴰⵡⴷ ⴰⴷ ⵏⵍⵙ ⵉⴷⵓⴽⴰⵏ	يمكن أيضا أن نرتدي الأحذية التقليدية
ⵙⴰⵡⵍ ⴰⵖ ⵢⴰⵏ ⵉⵎⵉⴽⴽ ⵖⴼ ⵢⵉⵖⴼ ⵏⵏⴽ	حدّثنا عن نفسك قليلاً
ⵉⵇⵇⴰⵏ ⴷ ⴰⴷ ⵏⵙⵙⵏ ⴰⵏⴰⵡ ⵏ ⵓⵎⵓⴽⵔⵉⵙ ⵍⵍⵉ ⵉⵙⵔⴳ ⵓⵎⵙⵡⵓⵔⵉ	يجب أن ندرك نوعية المشكل الذي تسبب في الأجير
ⴷⴰⵔ ⵜⴷⵓⴽⵜⵓⵔⵜ ⵏⴰⵣⴽ ⵙⵙⵎⵍⴰⵍⵉ ⵜⴰⵎⴰⵣⵣⴰⴳⵜ ⴳ ⵜⴷⵓⵙⵉ ⵏ ⵡⵓⵅⵙⴰⵏ	عند الدكتورة نازك السملالي المختصة في صحة الأسنان
ⴷ ⵜⴰⴷ ⴰ ⵉⴳⴰⵏ ⵜⴰⵥⵓⵕⵉ	وهذا هو الفن
ⵎⴰⵛⵛ ⵉⵍⵍⴰ ⴼⵍⵍⴰⵙ ⴰⴷ ⵉⵙⵙⵉⴷⵔⵓⵙ ⴰⴽⵎⴰⵢ	لكن عليه أن يقلل من التدخين
ⴷ ⴰⵡⴷ ⵜⴰⵎⴰⵜⴰⵔⵜ ⵖⴼ ⵜⵣⵣⵡⴰ ⴷ ⵜⴰⵎⵎⵏⵜ	وكذلك آية عن النحل والعسل
ⴰⵛⴽⵓ ⴷⴰ ⵜⵜⴹⴽⴰⴹⵏ ⴰⵢⵍⵍⵉ ⵔⴰⴷ ⵉⵣⵣⵔⵉ	بحيث يتوقعون ما سيقدمه لهم
ⵎⴰⵛⵛ ⵔⴰⴷ ⵉⴳ ⴰⵎⴰⵔⴰⵡ ⵏⵖ ⵜⴰⵎⴰⵔⴰⵡⵜ	بل سيصبح أبا أو أما
ⴰⵡⴷ ⵜⴰⵎⵖⴰⵔⵜ ⴽⵔⴰ ⵏ ⵜⴽⴽⴰⵍ ⴷⴰ ⵜ ⵜⵙⴽⴰⵔ	حتى المرأة أحيانا تمارسه
ⴰⴼⴰⴷ ⴰⴷ ⵜⵖⴰⵎⴰ ⵜⵉⵏⵉⵔⵜ ⵜⵔⵖⴰ	لتبقى الشمعة مشتعلة
ⴷ ⵜⵖⴰⵣⵓⵜ ⵜⴰⵥ ⵉ ⴰⵢⵜ ⵜⵎⵏⴰⴹⵜ	وتغازوت قريبة لمن هم في المنطقة
ⴷⴰ ⵜⴻⵜⵜⴰⴼⴰⴷ ⵎⴷⴷⵏ ⴷⴰ ⵜⵜⵉⵔⵉⵏ ⴰⴷ ⵙⵍⵍⴰⵏ ⵏ ⵢⴰⵏ ⴳⵉⵙⵏ	تجد الناس يميلون لسماع أحدهم
ⴷⴰⵔⵉ ⵜⵉⵡⵓⵔⵉⵡⵉⵏ ⵜⵉⵏⵎⵣⴳⵓⵏⵉⵏ ⵉⴳⴰⵏ ⵜⵉⵔⵔⴰ ⵉⵏⵓ ⴷ ⵓⵙⵙⵓⴼⵖ ⵉⵏⵓ	لدي أعمال مسرحية من كتابتي وإخراجي
ⵉⵔⵡⴰⵙ ⵉⵔⴳⴰⵣⵏ ⵉⴼⴽⴰ ⴰⵙⵏ ⵕⴱⴱⵉ ⵉⵎⵉⴽⴽ ⵏ ⵜⵖⵉⵙⵜ	ربما الرجال قد وهبهم الله بعض الذكاء
ⴳ ⵓⵏⵛⵜ ⵏ ⵎⴰⵏⵎⴽ ⵜⴳⴰ ⵜⵡⵓⵔⵉ ⵏ ⵓⵎⵙⴰⵖ	حسب طبيعة عمل الزبون
ⴰⵛⴽⵓ ⴷⴰ ⵏⵜⵜⴷⴷⵔ ⴳ ⵜⵓⴷⵔⵜ ⴰⴷ	لأننا نعيش بهذه الحياة
ⵉⵍⵍⴰ ⵓⴽⵍⵓ ⵏ ⵓⵎⵍⴰⵍ ⴷ ⵢⵉⴽⵯⵍⴰⵏ ⵉⵎⵙⴰⵎⴰⵏⵏ	هناك اللون الرملي و الألوان المائية
ⴰⵔ ⴽ ⵏⵙⵏⵉⵎⵎⵉⵔ ⴰ ⵛⵛⵉⴼⴼ ⵃⵎⴰⴷ ⵖⴼ ⵜⵉⵔⵎⵜ ⴰⴷ ⴱⴰⵀⵔⴰ ⵢⴰⴹⴼⵓⵜⵏ	نشكرك شيف حماد على هذه الوصفة الشهية جدا
ⴷⴰ ⵙⴳⵉⴽ ⵉⵜⵜⵉⵔⵉ ⵓⵢⴰⵏⵏ ⴰⵜⵜⴰⵢⵏ ⵏ 25 ⴰⵔ 40 ⵏ ⵡⴰⵙⵙ	يتطلب منك ذلك تقريبا من 25 إلى 40 يوما
ⵎⴰⵛⴰ ⴰⵎⵣⴰⵔⴰⵢ ⴳⵔⴰⵜⵙⵏ ⵉⵍⵍⴰ ⴳ ⵉⵙⴰⵖⴷⵏ	لكن الإختلاف بينهم يكون في الأهداف
ⵖⵉⵍⴰ ⵍⵍⵉⴳ ⵙⵖⴰⵏⵜ ⵉⵎⴰⵙⵙⵏ ⴰⴷ	الآن بعد شرائهم لهذه الآلات
ⵖⵉⴷ ⵔⴰⴷ ⵏⵙⴰⵡⵍ ⵖⴼ ⵓⵎⵙⴰⵔⵓⴼ	هنا سنتحدث عن التسامح
ⵖⵉⵍⴰ ⴷⴰ ⵏⵥⵕⵕⴰ ⵎⵏⵏⴰⵡⵜ ⵜⵏⴼⵍⵉⵜⵉⵏ	حاليا نرى عدة تطورات
ⵉⴳⴰ ⵜ ⵍⵍⵉⴳ ⴷⴰ ⵙⵜⴰⵢⵏ ⵙ ⵜⵖⴰⵔⴰⵙⵜ ⵜⴰⴳⴰⵛⵓⵔⴰⵏⵜ	هو أنهم يختارون بطريقة عشوائية
ⵉⴼⴽ ⴰⵙ ⵉⵎⵉⴽⴽ ⵏ ⵡⴰⵣⴰⵍ	ويجود عليه ببعض القيمة
ⴳ ⵜⵣⵡⵉⵔⵉ ⵏⵔⴰ ⴰⴷ ⵏⵙⵙⵏ ⵎⴰⵢⴷ ⵙⵉⵙⵏ ⵏⵡⴰⴷⵙ ?	في البداية نريد أن نعرف ماذا نقصد بها ؟
ⵎⴰⵙ ⵜⵥⴹⴰⵕⴷ ⴰⴷ ⵜⵙⴽⵔⴷ ⵜⴰⵡⵓⵔⵉ ⵏⵏⴽ ⵙⴳ ⵜⴳⵎⵎⵉ ⴽⴰ	أنك تستطيع أن تقوم بعملك من البيت فقط
ⵣⵓⵏ ⴷ ⴱⵉⵙⴽⵡⵉ ⵏⵏⴰ ⴳ ⵓⵔ ⵉⵍⵍⵉ ⵓⴳⵍⵓⵜⵉⵏ	مثل البسكويت الذي لا يحتوي على الغلوتين
ⴷⴰ ⵙⵎⵓⵜⵜⵓⴳⵏ ''ⵍⴱⵙⵉⵙ'' ⵉ ⵜⵎⵖⴰⵔⵜ	فهم يحضرون ’’البسيس‘‘ للمرأة
ⵉⵍⵍⵓⵖⵎⵜ ⵖⴼ ⵓⵏⴱⴰⴹ ⴳ ⵓⵙⵡⵉⵔ ⵏ ⵉⵎⵙⵍⵉ ⵏⵏⵙ	ويتدرب على التحكم في نبرة صوته
ⵏ ⵡⵉⵍⵍⵉ ⵉⵔⴰⵏ ⴰⴷ ⴰⵡⵉⵏ ⵜⵉⵎⵍⵙⵉⵜ ⵜⴰⵎⴰⵣⵉⵖⵜ	الراغبين في الحصول على اللباس الأمازيغي
ⵉⵥⴹⴰⵕ ⵓⵙⴳⵎⵉ ⵏⵏⵙ ⴰⴷ ⵢⵉⵍⵉ ⵉⴼⵓⵍⴽⵉ	بإمكان تربيتة أن تكون حسنة
ⵍⵍⵉⴳ ⵜⵜ ⵉⵏⵏ ⴽⴽⵉⵖ ⵎⵥⵥⵉⵢⵖ ⴰⵙⴳⴳⵯⴰⵙ ⵏ 1987	عندما كنت صغيرة سنة 1987
ⴽⵎⵎⵉ ⴰⵢⴷ ⵉⵙⵎⵓⵜⵜⴳⵏ ⴰⵢⴰⴷ ⴰⴽⴽⵯ?	أنت من أعددت كل هذا ؟
ⵏⴱⴱⵉ ⵜ ⵖⴼ ⴽⵕⴰⴹ ⵉⴳⵣⵎⴰⵏ	وقطعناها إلى ثلاث قطع
ⵍⵍⵉⴳ ⵍⵍⴰⵏⵜ ⵜⴳⵓⵔⵉⵡⵉⵏ ⵏⵏⴰ ⵉⵙⵙⵎⵔⴰⵙ ⵓⴼⴳⴰⵏ ⴳ ⵜⵓⴳⵜⵜ ⵏ ⵉⴳⵔⴰⵏ	نظرا لوجود كلمات يستعملها الإنسان في مختلف المجالات
ⵙ ⵓⵙⵔⴰⴳ ⵏ ⵓⵙⴼⵙⵙ ⵏⵏⵙⵏ ⴳ ⵜⴳⵎⵎⵉ	بسبب قمعهم في المنزل
ⵙ ⵓⵎⴷⵢⴰ, ⴽⵓⴷⵏⵏⴰ ⵏⴷⴷⴰ ⵙ ⵓⵙⵓⵏ ⴳ ⵜⵏⵓⵕⵥⵎⵜ, ⴷ ⵏⵜⵜⵎⴰⵇⵇⴰⵔ ⵜⵉⵎⵖⴰⵔⵉⵏ ⴰⵏⵏ	مثلا عندما نذهب للقرية بالعطل و نلتقي بتلك النساء
ⵉⵙ ⵉⵙⵏⴰⵎⴽ ⵎⴰⵙ ⵉⵍⵍⴰ ⵓⵎⵏⵣⴰⵖ ⴷ ⵢⵉⵎⴰⵏ?	هل معناه أن هناك صراع مع الذات؟
ⵢⴰⵀ ⵥⴹⴰⵕⵏ ⴰⴷ ⴰⵙ ⵙⵔⴳⵏ ⵉⵎⵓⴽⵔⵉⵙⵏ	نعم قد تسبب لهم مشاكل
ⵜⵓⵏⵏⵓⵏⵜ ⴰⵙⵙ ⴰⴷ ⵜⴳⴰ ⵜⴰⵖⴰⵡⵙⴰ ⵉⵜⵜⵣⵔⵉⵔⵏ ⵖⴼ ⵜⴷⵓⵙⵉ ⵜⴰⵏⵉⵎⴰⵏⵜ	الرياضة اليوم شيء يؤثر على الصحة النفسية
ⴷⴰ ⵏⵜⵜⵉⵏⵉ ⵎⴰⵙ ⵍⵍⴰⵏⵜ ⴳ ⵜⵡⵉⵍⴰ ⵏ 'X'	نقول إنهما على شكل X
ⵢⴰⵀ ⴷⴰ ⵜⵜⵖⴰⵎⴰⵏ ⴰⵣⵎⵣ ⵉⵖⵣⵣⵉⴼⵏ	نعم تبقى مدة طويلة
ⴰⴽⵓⴷ ⵏⵏⴰ ⵓⵔ ⵜⵍⵍⵉ ⵜⴼⵔⴽⵜ ⴰⴷ	آنذاك تغيب هذه المرحلة
ⴷⴰ ⵜⴻⵜⵜⵏⴼⴰⵍ ⵜⴳⵔⵔⴰⵡⵜ	تتغير العقلية
ⵎⴰⵙ ⴷ ⴱⴰⴱⴰⵙ ⴷ ⵉⵎⵎⵉⵙ ⵔⴰⴷ ⵏⴳⴰⵔⴰⵏ ?	بأن والده و والدته سينفصلان؟
ⴳ ⵓⵏⵛⵜ ⵏ ⵡⴰⵏⴰⵡ ⵏ ⵡⴰⵣⵣⴰⵔ	لحسب نوعية الشعر
ⵜⵉⵎⵢⵓⵔⵉⵏ ⴷⴰ ⴰⴽ ⵙⵙⵔⵅⵓⵏⵜ ⴰⵖⴰⵔⴰⵙ ⴷ ⵜⵜⴰⵊⵊⴰⵏⵜ ⵉⴳⵣⵣⵓⵍ	العادات تُسهّل عليك الطريق وتجعله قصيرًا
ⴰⵛⴽⵓ ⵜⴰⵎⵖⴰⵔⵜ ⴷⴰ ⴷ ⵜⴻⵜⵜⴰⵛⴽⴰ ⴷ ⵓⵔ ⴷⴰⵔⵙ ⵜⴰⵎⵙⵙⵏⴰ ⵖⴼ ⵢⵉⴳⵔ ⴰⴷ	لأن المرأة تأتي و ليس لديها دراية بالمجال
ⴰⴼⴰⴷ ⴰⴷ ⵏⵥⵕ ⵎⴰⵢⴷ ⴰⵖ ⵉⵙⵎⵓⵜⵜⴳ ⴳ ⵜⴳⵟⵟⵓⵎⵜ ⵏ ⵜⵉⵔⴰⵎ ⵏⵏⵙ	لنرى ماذا أعد لنا في فقرة وصفاته
ⴷⴰ ⵉⵔⵏⵏⵓ ⵉⵎⵖⵓⵣⵏ ⴷ ⴽⴰⵍⵙⵢⵓⵎ	يقوم بزيادة المعادن والكالسيوم
ⴷⴰⵜ ⴰⴷ ⵙⴽⵔⵏ ⵜⵓⵏⵏⵓⵏⵜ, ⵉⵇⵇⴰⵏ ⴷ ⴰⴷ ⵙⴽⵔⵏ ⵉⵎⵓⵙⵙⵓⵜⵏ ⵏ ⵓⵙⵙⵔⵖ	وقبل ممارسة الرياضة يجب أن يقوم بحركات تسخينية
ⴳ ⵉⵙⴳⴳⵯⴰⵙⵏ ⴰⴷ ⵉⵎⴳⴳⵓⵔⴰ, ⵢⵓⵍⵉ ⵡⵓⵟⵟⵓⵏ ⵏ ⵉⵎⵙⴽⴰⵔⵏ ⵏⵏⵙ ⴳ ⵜⵖⴰⵣⵓⵜ	في السنوات الأخيرة إرتفع عدد الممارسين في تغازوت
ⵎⴰⵛⵛ ⵍⵍⴰⵏ ⵡⴰⴷⴷⴰⴷⵏ ⴱⴰⵀⵔⴰ ⴷⵔⵓⵙⵏⵉⵏ	لكن هناك حالات قليلة جدا
ⵏⴰⵙⵉ ⴷ ⵜⴰⵎⵙⵙⵉⵣⴷⴳⵜ ⴰⴷ ⵜⵜ ⵏⵙⵙⵉⵣⴷⴳ	و نأخذ مصفاة لتصفيتها
ⴷ ⴰⵔ ⴽⵎ ⵙⵏⵉⵎⵎⵉⵔⵖ ⵖⴼ ⵓⵙⵇⵙⵉ ⴰⴷ	كما أشكرك على هذا السؤال
ⵓⵔ ⴷⴰ ⵜⵙⵢⴰⴼⴰⴷ ⵙ ⵓⵏⵓⵙⵔⵓ	لا تحس بالنقص
ⵏⴱⴱⵉ ⵢⴰⵜ ⵜⵍⵉⵜⵛⵉⵏⵜ ⵖⴼ ⵙⵉⵏ ⵉⴳⵣⵎⴰⵏ	ونقوم بتقطيع برتقالة إلى نصفين
ⵉⵍⵎⵎⴰ ⵜⴱⴷⴷⴻⴷ ⵖⴼ ⵓⵎⵜⵛⵓ ⴷ ⵓⵙⵡⵍⴼ ⴷ ⵉⴷⵍⴰⴳⵏ	إذن تكونين مسؤولة من الأكل والتصوير والديكورات
ⴰⵙⵜⴰⵢ ⵏ ⵜⵉⴼⵙⵜ, ⴷ ⵎⴰ ⵉⵍⵍⴰⵏ ⴳ ⵍⵎⵓⴹⴰ	إختيار الثوب، وماهو دارج في الموضة
ⵉⵍⵍⴰ ⴱⵍⵍⴰⴽ ⴰⴷ ⵜⵙⵉⴳⴳⵍⴷ ⵜⴰⵡⵓⵔⵉ ⵜⵙⵏⴼⵍⵉⴷ ⵜⵉⵥⴹⴰⵕⵉⵏ ⵏⵏⴽ	عليك البحث عن عمل وتطوير قدراتك
ⴰⴼⴰⴷ ⴰⴷ ⵏⴹⴼⵕ ⵜⵉⵔⵎⵜ ⵍⵍⵉ ⴰⵖ ⵉⵙⵎⵓⵜⵜⴳ ⴰⵙⵙ ⴰⴷ	لنتابع الوصفة التي أعدها لنا اليوم
ⴰⵢⴰⴷ ⴰ ⵖⴼ ⴷⴰ ⵙⴰⵡⴰⵍⵏ ⵎⴷⴷⵏ ⵖⴼ ⵉⴼⵓⴽⵙⵏ ⵏ ⵜⵓⴷⵔⵜ	لذلك يتحدث الناس عن المهارات الحياتية
ⵉⵙ ⵜⵥⴹⴰⵕⴷ ⴰⴷ ⴰⵖ ⵜⵣⵣⵔⵉⴷ ⵢⴰⵜ ⵜⴰⵍⵍⵖⴰⵜ ⵙⴳ ⵜⵣⵍⴰⵜⵉⵏ ⵏⵏⴽ	هل يمكن أن تقدم لنا مقطعا من أغانيك
ⵙ ⵜⵖⴰⵔⴰⵙⵜ ⴰⴷ ⵏⵜⵜⴽⴽⵙ ⵜⵉⴼⴰⵙⴰⵡⵉⵏ ⵜⵓⵣⴷⵉⵔⵉⵏ	بهذه الطريقة نتخلص من الطاقات السلبية
ⵉⵇⵇⴰⵏ ⴷ ⴰⴷ ⵏⵙⵙⵏ ⵎⴰⵙ ⴷ ⴰⴼⴳⴰⵏ ⴰⵔ ⵣⵡⴰⵔ ⵉⵛⵜⵜⴰ ⴰⵎⵜⵛⵓ ⵙ ⵉⵎⵣⴳⴰⵏ ⵏⵏⵙ	يجب أن نعرف بأن الإنسان يتناول الطعام أولا بأذنيه
ⵓⵔ ⵜⵍⵍⵉ ⵢⴰⵜ ⵜⵖⴰⵔⴰⵙⵜ ⵉⴳⴰⵏ ⵉ ⴽⵓ ⵢⴰⵏ	ليست هنالك طريقة موحدة تلائم الجميع
ⵏⵏⵄⵏⴰⵄ ⵔⴰⴷ ⴰⵖ ⵉⴼⴽ ⵜⴰⵎⵓⵖⵍⵉ ⵉⵥⵉⵍⵏ	النعناع سيمنحها منظرا جميلا
ⵉⵍⵎⵎⴰ ⵏⵏⵉⵖ ⵎⴰ ⵖⴼ ⵓⵀⵓ	فقلت لما لا
ⴷ ⵓⵙⴽⴽⴰ ⵔⴰⴷ ⵢⴰⴼ ⴰⵙⵙ ⴰⴷ	وغدا سيكون أحسن من اليوم
ⵢⴰⵀ, ⵜⵍⵍⴰ ⵜⵓⵇⵇⵏⴰ ⵎⴰⵛⵛ ⵓⵔ ⴷ ⵏⵜⵜⴰⵜ ⴰ ⵔⴰⴷ ⴰⵎ ⵉⵎⵍ ⴰⵙⵔⴰⴳ	نعم، هناك علاقة لكن لست من سيخبرك بالسبب
ⴷ ⵎⴰⵏⵎⴽ ⵥⴹⴰⵕⵖ ⴰⴷ ⵜⵏⵜ ⵍⴽⵎⵖ?	و كيف بإمكاني تحقيقها؟
ⵉⵎⴽⵍⵍⵉ ⵏⵏⵉⵖ ⵜⴰⴷ ⵜⴳⴰ ⵜⴰⵍⵍⵖⴰⵜ ⵜⴰⵎⵣⵡⴰⵔⵓⵜ ⵉⵔⵉⵔⵖ	كما ذكرت لك هذه أول أغنية أغنيها
ⵍⵍⵉ ⴳ ⴷⴰ ⵜⵙⴳⴰⴷⴷⴰ ⵜⵓⴳⵜⵜ ⵏ ⵜⵎⵜⵜⴰⵡⵉⵏ ⵏ ⵓⵙⵖⵓⴷⵓ	التي تصنع فيها الكثير من مواد التجميل
ⵎⴰⵢⴷ ⵜⴳⴰ ⵜⵖⵜⴰⵙⵜ ⵍⵍⵉ ⵙⴳ ⵔⴰⴷ ⵙⵙⴱⵖⵔⵖ	ما هو القرار الذي سأستفيد منه
ⵜⴻⵜⵜⵓⵙⵙⴰⵏ ⵙ ⵜⵢⵢⵓⵖⵜ ⵏ ⵕⵕⴰⴱⴱ ⴳⵔ ⵓⵙⴳⴳⵯⴰⵙ ⵏ 2004 ⴰⵔ 2006	عرفت بموجة الراب بين سنتي 2004 إلى 2006
ⵉⵇⵇⴰⵏ ⴷ ⴰⴷ ⵏⵥⵕ ⵉⴳ ⵉⵍⵍⴰ ⵓⴼⵔⴰⴽ ⴰⵙⴳⵎⴰⵢ ⴷⴰⵔ ⵉⵎⴰⵔⴰⵡⵏ ⴳ ⵓⵙⴳⴰ ⵏ ⵡⴰⵔⵔⴰⵡⵏ ⵏⵏⵙⵏ	يجب أن نرى إن كان للآباء وعي تربوي تجاه أبنائهم
ⴳ ⵜⵣⵡⵉⵔⵉ ⵉⵍⵍⴰ ⵖⴼ ⵓⴼⴳⴰⵏ ⴰⴷ ⵉⵙⴰⵡⵍ ⵖⴼ ⵎⴰⵢⴷ ⵉⵙⵙⵏ	في البداية على الإنسان أن يتحدث فيما يعرف
ⵍⵍⵉ ⵎⵔⴰ ⴷ ⵓⵔ ⵜⵓⴳⴳⵯⴰⵙ ⵏⵏⵙ ⴷ ⵢⵉⵡⵉⵣ ⵏⵏⵙ ⵓⵔ ⵔⴰⴷ ⵍⴽⵎⵖ ⵉⵎⵙⴰⵖⵏ	والتي لولا مجهوداتها وسهرها لما بلغت الزبناء
ⵉⵎⴰⵏⵏⴰⵢⵏ ⵏⵏⵖ ⵉⵥⵉⵍⵏ ⵔⴰⴷ ⵏⴼⵜⵓ ⵖⵉⵍⴰ	مشاهدينا الأعزاء سننتقل الآن
ⵉⵏⴼⵍ ⵡⴰⴷⴷⴰⴷ ⵏⵏⴽ ⵙ ⵎⴰⵢⴷ ⵢⵓⴼⵏ	فيتغير مزاجك نحو الأفضل
ⵏⴳ ⵏⵏ ⴰⴳⴳⵯⵔⵏ ⴳ ⵜⵎⴰⵛⵉⵏⵜ ⵏ ⵡⵓⴳⵓ	نضع الدقيق في آلة العجين
ⴷ ⵓⵍⴰ ⵜⵉⵔⴰ ⴷ ⵎⵏⵏⴰⵡⵜ ⵜⵖⴰⵡⵙⵉⵡⵉⵏ ⵢⴰⴹⵏⵉⵏ	كذلك الثريا والعديد من الأشياء الأخرى
ⵔⴰⴷ ⵏⵙⵎⵔⴽⵙ ⵖⵉⵍⴰ ⵉⴼⵔⴷⵉⵙⵏ ⵓⵎⴷⴷⴰⴽⴽⵯⵍ	سنمزج الآن جميع هذه العناصر
ⴷⴰ ⵏⵥⵕⵕⴰ ⵎⴰⵙ ⴷⴰ ⵉⵣⵣⵉⴳⵉⵣ ⴳ ⵢⴰⵏ ⵓⵖⴰⵔⴰⵙ ⵜ ⵉⴷ ⵉⵙⵙⴰⴳⴳⵯⴰⵏ ⵙ ⵜⵖⴰⵔⴰⵙⵜ ⵉⴼⵓⵍⴽⵉⵏ	نرى أنه يسير في مسار يظهره بشكل جيد
ⵜⵉⵙⵙ ⵙⵏⴰⵜ, ⵜⴰⵢⵔⵉ ⵏⵏⴰ ⴷ ⵉⵇⵇⴰⵏⵏ ⴰⴷ ⵜⵉⵍⵉ ⴱⵍⴰ ⵜⵉⴼⴰⴷⵉⵡⵉⵏ	ثانيا، المحبة التي يجب أن تتحقق بدون شروط
ⵔⴰⴷ ⵏⴼⵜⵓ ⵖⵉⵍⴰ ⴷⴰⵔ ⵓⵍⵜⵎⴰⵜⵏⵖ ⵜⵓⴷⴰ ⴷ ⵛⵛⵉⴼ ⵃⵎⴰⴷ	سننتقل الآن عند أختنا تودا والشيف حماد
ⵡⴰⵏⵏⴰ ⵜ ⵉⵜⵜⵃⴹⵓⵏ	من يكبته
ⵎⴰⵛⵛ ⴷⴰ ⵜⴻⵜⵜⵔⴼⵓⴼⵏ ⵜⴰⵡⵏⴰ ⴷ ⵓⵣⵎⵣ ⵙ ⵓⵙⵔⴰⴳ ⵏ ⴽⵉⴳⴰⵏ ⵏ ⵉⵎⵙⴽⴰⵔⵏ	لكن يتشتت التركيز مع مرور الوقت بسبب عدة عوامل
ⵉⵇⵇⴰⵏ ⴷ ⴰⴷ ⴼⵜⵓⵖ ⴷⴰⵔ ⵓⵙⵍⵎⴰⴷ	يجب أن أذهب عند الأستاذ
ⴰⵛⴽⵓ ⵍⵍⴰⵏ ⴽⵉⴳⴰⵏ ⵏ ⵉⴱⵕⵕⴰⵏⵉⵢⵏ	لأن هناك العديد من الأجانب
ⴷⴰ ⵏⵥⵕⵕⴰ ⵎⴰⵙ ⴷ ⵜⴰⵎⵖⴰⵔⵜ ⵜⵍⵍⴰ ⴱⴷⴷⴰ ⴳ ⵜⴼⵉⵍⵉⵏ ⵏⵏⵎ	نرى أن المرأة دائمة الحضور في لوحاتك
ⴷⴰ ⵜⵜⵓⵙⴽⵔⵏⵜ ⵙ ⵜⵎⵜⵜⴰⵡⵉⵏ ⵜⵉⴽⵔⵓⵔⴰⵏⵉⵏ	تتشكل من مواد كيميائية
ⵍⵍⵉ ⴳ ⴷⴰ ⵜⵜ ⵏⵜⵜⴰⴼⴰ ⴳ ⵜⵎⵚⵕⴰⵢ ⴷ ⵜⴷⴰⵍⵉⵡⵉⵏ ⵏ ⵜⴰⵔⴷⴰ	حيث نجده في الصالونات والحمامات
ⵙⴳ ⵓⵢⵍⵍⵉ ⵓⵔ ⵜⵔⵉⴷ ⴰⴷ ⴽ ⵢⴰⵖ	مما لا تحب التعرض له
ⵎⴰⵛⵛ ⵓⵔ ⴷ ⵉⵇⵇⴰⵏ ⴰⴷ ⵜⵙⵢⴰⴼⴰⴷ ⵙ ⵜⴽⵚⵚⴰⴹ ⴰⵛⴽⵓ ⵓⵔ ⵉⵍⵍⵉ ⵎⴰ ⵖⴼ	لكن يجب ألا تشعر بالخوف لأنه لا داعي لذلك
ⵏⴻⵏⵏⴰ ⵎⴰⵙ ⴷ ⵉⵎⵥⵢⴰⵏⵏ ⵥⴹⴰⵕⵏ ⴰⴷ ⵜⵏ ⴰⵖⵏ ⵉⴼⴷⵓⴷⴷⴰⵔ	ذكرنا أن الأطفال قد يصابون بالإلتهابات
ⵉⵍⵍⴰ ⵙ ⵜⵓⴳⵜⵜ ⴳ ⵓⵡⵔⴰⵖ ⵏ ⵜⴳⵍⴰⵢⵜ	يتواجد بوفرة في صفار البيض
ⵍⵍⵉ ⴳ ⵏⵙⵇⵙⴰ ⵖⴼ ⵉⴼⵙⵙⴰⵢⵏ ⵉⵍⵍⴰⵏ	التي نتسائل فيها عن الحلول الممكنة
ⵉⵙ ⴷⴰ ⴷⴰⵔⵙ ⵜⵜⵉⵍⵉⵏ ⵉⵎⵓⴽⵔⵉⵙⵏ	هل تعاني من مشاكل
ⵉⵎⵥⵥⵉⵢⵏ, ⵏⵏⴰ ⴷⴰⵔ ⴰⵏⴰⵡ ⴰⵏⵎⵙⵍⵉ, ⴷⴰ ⵜⵜⵔⵎⴰⵙⵏ ⵜⵉⵎⵙⵉⵔⵉⵏ ⵖⵙ ⵙ ⵜⵎⵙⵍⵉⵡⵜ	الصغار ممن لهم نمط سمعي، يفهمون الدروس فقط بالسمع
ⵓⵀⵓ, ⴳ ⵜⵓⴳⵜⵜ ⵓⵔ ⴷⴰ ⵉⵜⵜⴰⵖ ⴰⵣⵣⴰⵏⵏ	لا، عادة لا يصاب به الأطفال
ⴰⵎⵙⴼⴰⵔⴰ ⴰⵏⵎⴰⴽ ⵏⵏⵙ ⵉⴳⴰ ⴰⵙⵉⴽⵣ	فالتصالح معناه الإعتراف
ⴷⴰⵔⵙ ⵜⵓⵇⵇⵏⴰ ⴷ ⵜⵎⵜⵜⴰⵏⵜ ⵏⵖ ⴰⵟⵟⴰⵏ	لها علاقة بالموت أو بمرض
ⴰⴼⴰⴷ ⴰⴷ ⴷⵉⴽ ⵎⵔⴰⵔⴰⵏ ⵡⴰⵣⵣⴰⵏⵏ ⴰⴷ	ليتجاوب معك هؤلاء الأطفال
ⵉⵍⵍⴰ ⵎⴰ ⵉⵙⵢⴰⴼⴰⵏ ⵙ ⵓⵏⴳⴰⵥ ⵉⴳ ⵉⵙⵍⵉ ⵓⵃⴱⴱⵓ ⴰⴹⴰⵕ ⵏⵏⵙ	هناك من يحس بالألم إن لمس الغطاء قدمه
ⵉⵎⴰ ⵉⵎⵉⵔ ⵏ ⵓⵏⴱⴷⵓ ⴷ ⵜⴼⵙⵓⵜ	بالنسبة لفصل الصيف والربيع
ⴰⵛⴽⵓ ⵍⵍⴰⵏ ⵉⵎⵓⴹⴰⵏ ⴷⴰⵔⵙⵏ ⴰⵟⵟⴰⵏ ⵏ ⵓⵙⴽⴽⵯⴰⵔ	لأن هناك مرضى مصابين بداء السكر
ⵉⵎⴽⵍⵍⵉ ⵜ ⵜⴻⵜⵜⴰⵎⵥ ⵜⵎⵣⵉⵔⵜ ⴱⴰⵀⵔⴰ	كما أنه يصاب بالحكة كثيرا
ⵉⴳ ⵓⵔ ⴷⴰ ⵜⵙⴽⵔⴽⵉⵙⴷ	فإن كنت لا تكذب
ⴰⵛⴽⵓ ⴰⵎⵙⵙⵏⵜⵉ ⴰⵙⵉⵎⴰⵏ ⵉⴳⴰ ⴰⵙⴰⵜⵉ ⵓⵍⴳⵉⵏ	لأن المقاول الذاتي إطار قانوني
ⴰⴼⴰⴷ ⴰⴷ ⴷ ⵜⴰⴳⴳⵯ ⵜⵡⵉⵍⴰ ⵏ ⵓⴳⵏⵙⵓ ⵏⵏⵙ	حتى يظهر شكل باطنها
ⵉⴳ ⴰⵙⵔⴰⴳ ⵉ ⵓⵏⴳⵉⵔⵉ	ويكون سببا في الفراق
ⴹⴼⵕⴰⵜ ⴰⵖ ⴰⴼⴰⴷ ⴰⴷ ⵜⵙⵙⵏⵎ ⵎⴰⵢⴷ ⴰⵖ ⵜⵙⵎⵓⵜⵜⴳ	تابعونا لنتعرف على ما أعدته لنا
ⵔⴰⵛⵉⴷ ⴷⴷⵢⵢⴰⵏⵉ ⵉⴳⴰ ⴰⵎⵖⵔⵉⴱⵉ ⴳ ⵜⵖⵍⴰⵏⵜ ⴳ ⵜⵣⵡⵉⵔⵉ	رشيد الدياني مغربي الجنسية أولا
ⴰⴷ ⵜⵙⵙⵎⵔⵙ ⵜⴰⴳⵔⵓⵎⵎⴰ ⵏ ⵜⵖⴰⵔⴰⵙⵉⵏ	أن تعتمد على مجموعة من الطرق
ⵏⵖ ⵉⵍⵓⴳⴰⵏ ⵏⵖ ⴰⵀⵉⵍ, ⵙⵎⵎⵓ ⴰⵙ ⴰⵢⵏⵏⴰ ⵜⵔⵉⴷ	أو قواعد أو برنامج، سميه ما شئت
ⴰⵎⵔ ⴳ ⵜⵎⵥⵉ	إلا في الصغر
ⵣⵓⵏ ⵉⴳ ⵢⴰⴷⵍⵍⵉ ⵜⵙⴽⵔⴷ ⵉⵎⴽⴰⵏⵏ ⴰⴼⴰⴷ ⴰⴷ ⴰⵙ ⵜⵙⵙⵅⵙⵔⴷ ⵜⵓⴷⵔⵜ ⵏⵏⵙ	كأن فعلك مقصود لتفسدي عليه حياته
ⴷⴰ ⵉⵢⵉ ⴱⴰⵀⵔⴰ ⴰⴽⴽⴰⵏ ⴰⵡⵔⵉⴽ ⵏ ⵓⵡⵙⵙⴰⵔ	يمنحونني كثيرا شخصية الكبير في السن
ⴰⵢⴰⴷ ⴰ ⵉⴳⴰⵏ ⵜⵓⵎⴰⵢⵜ ⵏ ⵜⵉⵍⵉⴼⵓⵏ ⵏⵏⵙ	هذا هو محتوى هاتفه
ⵙ ⵜⵙⴰⴷⵓⵔⵜ ⵜⴰⵖⵏⵙⴰⵏⵜ	بالتغذية النضالية
ⵙⵡⵉⵏⴳⵎⵖ ⴳ ⴰⴷ ⴰⵔⵎⵖ ⵜⴰⵔⵎⵉⵜ ⴰⴷ	ففكرت في خوض هذه التجربة
ⵢⴰⵀ, ⴰⴼⴰⴷ ⴰⴷ ⵏⵙⵙⵏ ⵜⴰⵙⵎⴽⵜⴰ ⴷ ⵡⴰⵏⴰⵡ ⵏ ⵓⴼⵉⵜⴰⵎⵉⵏ ⵍⵍⵉ ⵔⴰⴷ ⵏⴼⴽ	نعم، لنعلم كمية ونوعية الفيتامين الذي سنمنحه
ⴷ ⵉⵎⵙⵙⵓⴼⴰⵖ ⴷ ⵉⵎⴰⵔⴰⵜⵏ ⵏ ⵙⵙⵉⵏⴰⵔⵢⵓ	والمخرجين وكتاب السيناريو
ⵓⵔ ⵉⴳⵉ ⵜⴰⵖⴰⵡⵙⴰ ⵉⵏⵀⵍⵏ	ليس بالأمر السهل
ⵢⵓⵔⵔⵉ ⴷ ⵉⵣⵎⵓⵎⵎⴳ, ⵢⵉⵏⵉ ⵉⵢⵉ ⵎⴰⵙ ⴷ ⴰⵢⴰⴷ ⵉⵙⵙⴽⵜⵉ ⵜ ⵉⴷ ⵙ ⵉⵎⵎⵉⵙ ⵉⵎⵎⵓⵜⵏ	رجع وإبتسم فأخبرني أن هذا ذكره بوالدته المتوفية
ⴷⴰ ⵉⵜⵜⵉⵍⵉ ⵓⵢⴰⵏⵏ ⴳ ⵓⵏⵛⵜ ⵏ ⵡⴰⵏⴰⵡ ⵏ ⵜⵎⵖⵔⴰ	يكون ذلك بحسب نوع حفل الزفاف
ⴰⴼⴰⴷ ⴰⴷ ⵏⵎⵢⴰⵙⵙⴰⵏ ⵖⴼ ⵓⵏⴳⵔⴰⵡ ⴰⵎⵙⴰⴷⵓⵔ ⵏⵏⴰ ⵥⴹⴰⵕⵏ ⵉⵎⵓⴹⴰⵏ ⵏ ⵓⴹⴰⵕ ⵏ ⵓⵙⴽⴽⵯⴰⵔ ⴰⴷ ⵜ ⴹⴼⵕⵏ	لكي نتعرف على الحمية التي يستطيع مرضى قدم السكري إتباعها
ⵏⵏⴰ ⵔⴰⴷ ⴰⵖ ⵉⵙⴰⵡⵍ ⵖⴼ ⵜⵖⵉⵙⵜ ⵜⴰⴼⵔⵢⴰⵏⵜ	الذي سيحدثنا عن الذكاء العاطفي
ⵏⵙⵎⵓⵎⵎⵉ ⵖⴼ ⵓⵢⵍⵍⵉ ⵉⵎⵙⴰⵔⵏ	فنتذمر مما حدث
ⴽⵓ ⵜⵓⵏⵏⵓⵏⵜ ⴷⴰⵔⵙ ⴰⵙⵙⴰⵔⵏ ⵏⵏⵙ	لكل رياضة إحتياجاتها
ⵜⵙⵙⵏⵀ ⵜⵓⴷⵔⵜ ⵏ ⵓⵏⴰⵎⵓⵔ	سهلت حياة المواطن
ⵉⵙ ⵜⴰⵙⴰ ⵏ ⵓⵙⵍⵎ ⵜⵍⵍⴰ ⴳ ⵉⴳⴰⴷⴰⵣⵏ?	هل كبد السمك متوفر في الأسواق؟
ⴷ ⵔⴰⴷ ⵢⵉⵍⵉ ⵓⴱⵓⵖⵍⵓ ⴰⴷⵎⵙⴰⵏ	و سيكون هناك إنتعاش إقتصادي
ⵔⵉⴷ ⴰⴷ ⵜⵙⴰⵡⵍⴷ ⵖⴼ ⵢⵉⴳⵔ ⵏ ⵜⵙⵏⴰⴼⴰⵜ	أريد أن تتحدثي حول مجال البصريات
ⵎⴰⵢⴷ ⵉⴳⴰ ⵓⵙⵎⵎⵜⵔ ⵏⵏⴰ ⵜⴰⴽⴽⴰⴷ ⵉ ⵜⵎⵖⴰⵔⵉⵏ	ما هي النصيحة التي تقدمينها للنساء
ⴳ ⵜⵓⴷⴷⵙⴰ ⵏⵏⵙ ⵜⵓⴷⵎⴰⵡⴰⵏⵜ	في تركيبتهم الشخصية
ⴰⵢⴰⴷ ⴰ ⵖⴼ ⴷⴰ ⵏⵙⵎⵎⵜⴰⵔ ⵎⴷⴷⵏ ⴰⴷ ⵜ ⵉⵏⵏ ⵙⵉⵜⵜⵉⵢⵏ	لهذا ننصح الناس بالتخلص منها
ⵜⴰⵏⵏ ⵜⴳⴰ ⵜⴰⵎⵢⵓⵔⵜ ⵉⴼⵓⵍⴽⵉⵏ	تلك عادة حسنة
ⵥⴹⴰⵕⵖ ⴰⴷ ⵙⵙⵏⵖ ⴰⵍⵍⵖⴰⵜⵏ ⵉⴼⵓⵍⴽⵉⵏ	يمكنني من معرفة الألحان الشجية
ⵜⴰⵏⵎⵎⵉⵔⵜ ⵏⵏⵎ ⴱⴰⵀⵔⴰ ⴰ ⵜⴰⵙⵍⵎⴰⴷⵜ ⵣⵀⵕⴰ ⴰⵎⵏⴰⵢ	شكرا جزيلا أستاذة زهرة أمناي
ⴷ ⴰⴷ ⵉⵙⵙⵎⵔⴰⵙ ⵉⵏⵎⴳⴰⵍⵏ ⵏ ⵓⴼⴷⵓⴷⴷⵔ ⴷ ⵓⵏⴳⴰⵥ	ثم إستعمال مضادات الإلتهاب والألم
ⵉⵍⵎⵎⴰ ⵜⵔⵅⵓ ⵙⵓⵍ ⵜⵖⴰⵡⵙⴰ	تم يتيسر الأمر بعد ذلك
ⴷ ⵡⴰⴽⵓⴷ ⵏ ⵢⵉⵥⵕⵉ ⵏ ⵜⵉⵍⵉⴼⵉⵣⵢⵓⵏ ⴷ ⵡⴰⴽⵓⴷ ⵏ ⵡⵓⵔⴰⵔ	و وقت مشاهدة التلفاز و وقت اللعب
ⵉⵍⵎⵎⴰ ⵙⵙⵏⵜⵉⵖ ⴷⴰ ⵙⵙⴰⵖⵖ ⴽⵔⴰ ⵏ ⵡⴰⵏⴰⵡⵏ ⵏ ⵜⵖⵓⵎⵉ	ثم بدأت أقتني بعض أنواع الصباغات
ⵜⴳⴰ ⴰⴷ ⴰⵙⵏ ⴼⴽⵏ ⵜⴰⵢⵔⵉ	هو أن يمنحوهم الحب
ⵎⴰⵛⵛ ⵜⴰⵎⵏⵛⴽⵜ ⵏ ⵜⵕⵡⵉ ⵏⵏⵙ ⴷ ⵡⵉⵢⵢⴰⴹ 50%	بينما تكون نسبة فعاليتها مع الآخر 50%
ⵓⵔ ⴷⴰ ⴰⵖ ⵉⵜⵜⴰⵡⵙ ⴳ ⵓⵙⵙⵜⵓ ⵏ ⵉⵎⵓⴽⵔⵉⵙⵏ	لا يساعدنا على نسيان المشاكل
ⴷⴰ ⵜⵜⵉⵍⵉⵏ ⴽⵔⴰ ⵏ ⵉⵎⵓⴽⵔⵉⵙⵏ ⵍⵍⵉ ⵉⵙⵔⵓⴳⵏ ⵜⵓⴳⵜⵜ ⵏ ⵓⵎⵓⵙⵙⵓ	تحدث بعض المشاكل التي تسبب فرط الحركة
ⵣⵓⵏ ⴷ ⴳ ⵢⵉⴳⵔ ⵏⵏⵎ ⴰⴷ	سواء في مجالك هذا
ⴰⵙⴰⴽⴰ ⵏ ⵜⵏⴱⵓⵍⵜ, ⴰⵙⴰⴽⴰ ⵏ ⵜⴳⵥⵥⴰⵍ	مسار المثانة مسار الكلى
ⵉⵇⵇⴰⵏ ⴷ ⴰⴷ ⴰⵙ ⵜⵔⴰⵔ ⵜⵡⵊⴰ ⵜⴰⵢⵏⵉⵜ ⵜⵙⵖⵉⵡⵙ ⴰⵙ	يجب أن تنتبه له الأسر وتخطط له
ⴳ ⵉⵔⵣⴰⴼⵏ ⵏⵏⴰ ⵏⵙⴽⴰⵔ ⵉ ⵜⵉⵏⵎⴰⵍ, ⴷⴰ ⵏⵜⵜⴰⴼⴰ ⵢⴰⵏ ⵓⵏⵍⵎⴰⴷ ⵉⴳⵏ	في بعض الزيارات التي نقوم بها للمدارس نجد أحد التلاميذ نائما
ⴷⴰⵜ ⴰⴷ ⵏⴼⴼⵉ ⴰⵎⵍⴰⵍ ⴳ ⵉⵙⴳⵉⵡⵏ ⵏ ⵜⴳⵎⵎⵉ	قبل أن نرمي الرمل في جوانب المنزل
ⵎⴰⵙⵙ ⵎⴰⵙⵉⵏ ⴽⵔⵎⵓⵙ ⴰⵎⵏⵜⴰⴳ	سيد ماسين كرموس أمنتاك
ⴰⵔ ⴽ ⵙⵏⵉⵎⵎⵉⵔⵖ ⴱⴰⵀⵔⴰ ⴰ ⴰⵙⵍⵎⴰⴷ ⵓⵃⵙⴰⵢⵏ ⵖⴼ ⵉⵙⵉⵙⴼⵉⵡⵏ ⴰⴷ	أشكرك جزيلا أستاذ أوحساين على هذه التوضيحات
ⴷⴰ ⵣⵣⵉⴳⵉⵣⵏⵜ ⵙ ⵓⵥⵟⵟⴰ ⵣⵓⵏ ⴷ ⵜⵉⵎⵙⵙⵓⵔⵉⵏ	تسير بهيكلة مثل الشركات
ⵉⴳⴰ ⵉ ⵜⵎⵏⴰⴹⵉⵏ ⵜⵉⵎⵇⵔⴰⵏⵉⵏ ⴳ ⵡⵓⴷⵎ	فهو للمناطق الكبيرة في الوجه
ⴷ ⵓⵍⵍⵓⵣⵣⵓ ⵏ ⵜⴰⵢⵏⵉⵜ	وتشتت الإنتباه
ⵢⴰⵀ ⵜⵓⴼⵉⴷ ⵍⵇⴰⵎⵉⵔⴰ ⴷⴰⵔ ⴳⵯⵎⴰⴽ	نعم وجدت الكاميرا لدى أخيك
ⵉⵎⴰⵜⵔ ⴰⵙⴰⴽⴰ ⵏⵏⵙⵏ ⴰⵏⵎⵍⴰⵏ	أن يراقب مسارهم الدراسي
ⴷⴰ ⵜⵙⵡⵉⵏⴳⵉⵎⴷ ⴳ ⵡⴰⵡⴰⵍ ⵏⵏⴰ ⴰⴽ ⵉⵏⵏⴰ ⴽⵔⴰ ⵏ ⵢⴰⵏ ⴷ ⵎⴰⵏⵎⴽ ⵜⴼⵔⵔⵓⴷ ⵉⵕⵟⵟⴰⵍⵏ	تفكر في الكلام الذي قاله لك شخص ما وفي كيفية دفع الديون
ⵏ ⵜⴱⴰⴷⵓⵜ ⵜⴰⵎⴰⵣⵉⵖⵜ ⵖⵉⵏⵏⴰ ⴳ ⵜⵍⵍⴰⵎ	قناة تمازيغت أينما كنتم
ⴰⵛⴽⵓ ⵉⵍⵍⴰ ⵎⴰ ⵉⵙⴽⴰⵔⵏ ⴰⵙⵎⵓⵙⵙⵓ ⵉ ⵡⴰⵣⵣⴰⵏⵏ	لأن هناك من يقوم بالتنشيط الأطفال
ⵉⵖⴰⵍ ⵉⵙ ⴷⴰ ⵉⵙⵏⴼⴰⵍⴰⵢ ⵖⴼ ⵜⴰⵢⵔⵉ ⵏⵏⵙⵏ ⵙ ⵉⵎⴽⴰⵏⵏ, ⵎⴰⵛⴰ ⴷⴰ ⴼⵍⵍⴰⵙⵏ ⵉⵜⵜⴼⴼⵖ	يظن أنه يعبر عن حبهم بذلك لكنه يفسدهم
ⴰⵛⴽⵓ ⵉⴳ ⴷ ⴰⵏⴳⴰⵥ ⴰ ⵉⴳⴰⵏ ⵜⴰⵎⴰⵜⴰⵔⵜ ⵜⴰⵎⵢⵉⵡⵏⵜ	حيث إذا كان الألم هو العرض الوحيد
ⵉⵎⵡⴰⵜ ⴰⴷ ⵉⵙⵙⵏⴼⵍ ⵜⴰⵖⴰⵔⴰⵙⵜ ⵏ ⵓⵎⵔⴰⵔⴰ ⵏⵏⵙ ⴷⵉⴽ, ⴰⴼⴰⴷ ⴰⴷ ⵜⴷⴽⵜⴷ	فيحاول تغيير طريقة تعامله معك كي تهدأ
ⵏⵙⵔⵙ ⴰⴳⴳⵯⵔⵏ ⵏⵏⵉⴳ ⵏⵏⵙ	ونضع الدقيق فوقها
ⵉⵍⵎⵎⴰ ⵉⴳ ⵜⵜ ⵓⵔ ⵏⵉⵡⵉ ⴳ ⵓⵢⴰⴷ, ⴷⴰ ⵉⵙⵔⵓⴳ ⵉⵎⵓⴽⵔⵉⵙⵏ ⵙⵍⴰⵡⴰⵏ ⴰⴽⴽⵯ ⵎⴰ ⵉⵥⵍⵉⵏ ⵙ ⵓⵏⵏⵓⵎⵎⵙ	فإن لم نهتم هذا الأمر فإنه يخلف مشاكل خاصة فيما يتعلق بالتركيز
ⴳ ⵜⵉⵣⵉ ⵏ ⵓⵎⵙⴰⵔ ⵏⵏⵙ?	في فترة حدوثها؟
ⵍⵍⴰⵏ ⵉⵙⴰⴼⴰⵔⵏ ⵎⴳⴰⵍ ⵜⵉⵎⵉⵜⴰⵔ ⵏ ⵜⵡⵙⵔⵜ	هناك أدوية ضد أعراض الشيخوخة
ⵢⵓⴼ ⴷ ⵉⴼⵓⵍⴽⵉ ⵖⴼ ⵓⵢⵍⵍⵉ ⵔⴰⴷ ⵉⵊⵕⵓ ⴽⵓⴷⵏⵏⴰ ⵉⵜⵜⵓⵔⴳⴰⵍ ⴳ ⵜⴳⵎⵎⵉ ⵉ ⵡⴰⴹⵓ ⵏⵏⵙ	أفضل وأجود مما سيحصل عليه حين يسجن في البيت وحيدا
ⴰⵔ ⴽⵎ ⵙⵏⵉⵎⵎⵉⵔⵖ ⵖⴼ ⵓⵙⵏⴱⴳⵉ ⴳ ⵜⴱⴰⴷⵓⵜ ⵜⴰⵎⴰⵣⵉⵖⵜ	أشكرك على الإستضافة بقناة تمازيغت
ⴰⵢⴰⴷ ⴰⵢⴷ ⴷ ⵉⵜⵜⴰⵡⵉⵏ ⴰⴷ ⵓⵔ ⵢⵉⵍⵉ ⵓⵙⵏⴼⵍ	وهذا ما يؤدي إلى عدم التغيير
ⵏⵖ ⵜⵙⵡⵓⵔⵉ ⴳ ⴽⵔⴰ ⵏ ⵜⵡⵓⵔⵉ ⵉⵏⵀⵍⵏ ⴷ ⵢⵓⵙⴰⵏ	أو تشتغل في عمل يسير وملائم
ⴷ ⴽⵓⴷⵏⵏⴰ ⵜ ⵜⵙⴱⴷⴷⴻⴷ, ⵏⵜⵜⴰ ⴷⴰ ⵉⵙⵙⴱⵖⴰⵙ ..	وحين تقلع عنه فهو يحفز ..
ⵙ ⵓⵎⴷⵢⴰ ⴽⵓⴷⵏⵏⴰ ⵜⵍⵙⵙⴰⴷ ⵉⴱⵓⵔⴽⵙⵏ ⵉⴽⵕⵕⵓⵥⵏ	مثلا عندما ترتدي حذاءا ضيقا
ⴰⵢⴰⴷ ⵉⴱⴷⴷ ⵖⴼ ⵓⵙⵎⵓⵜⵜⴳ ⵏ ⵓⵎⵙⵡⴰⵍⴰ ⴰⵎⴰⵏⵓⵏ	هذا يعتمد على تكوين الموجه الرياضي
ⵎⴰⵢⴷ ⵜⴳⴰ ⵜⵓⵇⵇⵏⴰ ⵏ ⵓⴽⵎⴰⵢ ⴷ ⵜⵊⵕⵟⵓⵎⵜ ⵏ ⵓⵅⴷⵉⵍ?	ما هي علاقة التدخين بجرثومة المعدة؟
ⴷⴰ ⴰⵖ ⵢⴰⴽⴽⴰ ⵜⴰⵎⵍⴷⴰ ⴰⴼⴰⴷ ⴰⴷ ⵏⵙⵙⵏ ⵜⵉⵇⵉⴼⴰ ⵜⵓⵣⴷⵉⵔⵉⵏ ⴷⴰⵔ ⵡⴰⵣⵣⴰⵏ	ويعطينا فرصة للتعرف على النقط السيئة لدى الطفل
ⵉⵣⴷⵉ ⴷ ⵜⴰⵔⴰⵢⵜ ⵜⴰⴱⵕⵕⴰⵏⵉⵜ ⵏ ⵜⵖⵎⴰⵙ	له علاقة الطبقة الخارجية للأسنان
ⵎⴰⵛⵛ ⵉⵇⵇⴰⵏ ⴷ ⴰⴷ ⵏⵙⵙⵏ ⵎⴰⵙ ⴷ ⵜⴰⴼⵍⵙⵜ ⵏ ⵡⴰⵣⵣⴰⵏⵏ ⴳ ⵉⵅⴼⴰⵡⵏ ⵏⵏⵙⵏ	لكن لابد من معرفة أن ثقة الأطفال بأنفسهم
ⵜⴰⵡⵓⵔⵉ ⴱⵕⵕⴰ ⵏ ⵜⴳⵎⵎⵉ ⵜⵎⵔⴰ	فالعمل خارج البيت صعب
ⴷⵓⴽⵜⵓⵔ ⵄⴰⴱⴷⵓⵍⵍⴰⵀ ⴱⴰⵀⴰ	الدكتور عبد الله باها
ⵎⴰⵛⵛ ⵜⴰⵏⴼⵍⵉⵜ ⵏⵏⵙ ⵜⵥⵥⴰⵢ	لكن تطورها بطيئ
ⴰⵔ ⵢⴰⴽⴽⴰ ⵖⴼ ⵜⵎⵖⴰⵔⵜ ⵏⵏⵙ ⴷ ⵜⴰⵔⵡⴰ ⵏⵏⵙ	يصرف على زوجته و أبنائه
ⴷ ⵉⵎⴽⵍⵍⵉ ⵏⵙⵙⵏ ⵎⴰⵙ ⴷ ⵜⵉⵏⵎⵍ ⴷⴰ ⵜⴻⵜⵜⵓⵔⴰⵔ ⵢⴰⵜ ⵜⵎⵍⵉⵍⵜ ⵉⵀⵎⵎⴰⵏ ⴳ ⵓⵙⴳⵎⵉ ⵏ ⵓⵏⵍⵎⴰⴷ	فكما نعلم فإن المدرسة تلعب دورا هاما في تربية التلميذ
ⴽⵛⵎⵏ ⵉⵏⵏ ⵎⴷⴷⵏ ⵉⵍⵉⵏ ⴳ ⵓⴷⵖⴰⵔ ⵏ ⵓⵎⴰⵣⵣⴰⴳ	فيتدخل العامة وينتحلون صفة الأخصائيين
ⴷⴰ ⵜⵥⵕⵕⴰⴷ ⵎⴰⵙ ⴷ ⵍⴱⵚⵟⵉⵍⴰ ⵍⵍⵉ ⴰⴽⴽⵯ ⵉⵎⵎⵉⵎⵏ ⵜⴳⴰ ⵜⴰⵍⵍⵉ ⵜⵙⵎⵓⵜⵜⵓⴳ ⵉⵏⵏⴰⵎ ⵏⵖ ⵅⴰⵍⵜⵉⵎ	تعتبرين أن أشهى بسطيلة هي التي تحضرها أمك أو خالتك
ⵉⵎⵉⵔ ⵏ ⵜⴳⵔⵙⵜ ⵉ ⵡⴰⴹⵓ ⵏⵏⵙ, ⴷ ⴰⵡⴷ ⴰⵏⴱⴷⵓ ⴷ ⵜⴼⵙⵓⵜ	فصل الشتاء بمفرده وكذلك بالنسبة للصيف والربيع
ⵔⴰⴷ ⴷⴰⵖ ⵏⵙⴽⵔ ⵉⵎⴽⴰⵏⵏ	سنقوم بنفس العملية
ⵜⵉⴽⴽⵉ ⵏ ⵜⵙⵡⵉⵏⴳⵉⵎⵉⵏ ⵉ ⵎⴷⴷⵏ ⵥⴹⴰⵕⵏⵜ ⴰⴷ ⴰⵙⵏ ⴰⵡⵙⵏⵜ ⴳ ⵜⵓⴷⵔⵜ ⵏⵏⵙⵏ	إعطاء أفكار للناس يمكن أن تساعدهم في حياتهم
ⵜⴰⵏⵎⵎⵉⵔⵜ ⵏⵏⵎ ⴰ ⵜⴰⵙⵍⵎⴰⴷⵜ ⵣⵀⵕⴰ ⴰⵎⵏⴰⵢ	شكرا لك أستاذة زهرة أمناي
ⴷ ⴷⴰ ⵉⵙⵙⵓⵎⵓⵎ ⵜⵉⴷⵉ ⵏ ⵉⴹⴰⵕⵏ	كما أنه يمتص عرق القدمين
ⵓⵔ ⵉⵥⴹⵉⵕ ⴰⴷ ⵉⵙⵙⵎⵔⵙ ⵉⴱⵓⵔⴽⵙⵏ ⵉⵇⵇⵏⵏ	لايستطيع إستعمال الأحدية المغلقة
ⵙⵎⵣⴰⵣⴰⵍⵏ ⵜ ⴷ ⴽⵔⴰ ⵏ ⵢⴰⵏ ⵢⴰⴹⵏⵉⵏ	أو يقارنونه بشخص آخر
ⵜⴰⵎⵖⴰⵔⵜ ⵜⵓⵙⵔ ⵣⵡⴰⵔ	فإن المرأة تحتاج أولا
ⴷ ⵉⵙⴽⵔ ⵏ ⵜⵡⵍⵥⵉⵜ, ⴷⴰ ⴷ ⵉⵜⵜⴽⴽⴰ ⴰⴽⴰⵍⵙⵢⵓⵎ	والشوكة العظمية تكون نتاج ترسبات الكالسيوم
ⵜⵉⵙⵙ ⵙⵏⴰⵜ, ⴰⴷ ⵉⵙⵢⴰⴼⴰ ⵙ ⵡⵉⵢⵢⴰⴹ	ثانيا، يكون متعاطفا مع الآخرين
ⵙⴳ ⵉⴱⵕⵕⴰⵏⵉⵢⵏ ⴰⴼⴰⴷ ⴰⴷ ⵏⵙⴽⵔ ⵉⵇⵛⵓⵛⵏ ⵏ ⵙⵙⵉⵏⵉⵎⴰ	من الأجانب لصناعة أكسيسوارات السينما
ⴷⵓⴽⵜⵓⵔ ⵄⴰⴱⴷⵓⵍⵍⴰⵀ ⵔⴰⴷ ⴷ ⵏⵓⵔⵔⵉ ⴰⴷ ⵏⵙⵎⴷ ⴰⵎⵙⴰⵡⴰⵍ	دكتور عبد الله سنعود لنتمم الحوار
ⴷ ⴳ ⵢⴰⵜ ⵜⵉⵣⵉ ⵜⴳⴰ ⵜⵉⵕⵉⵕⴹⵜ	وبنفس الوقت هي أرضية
ⴷ ⵓⵎⴰⵜⵔ ⴷⴰ ⵉⵜⵜⵉⵍⵉ ⴳ ⴽⵔⴰ ⵏ ⵡⴰⴷⴷⴰⴷⵏ ⵉⵥⵍⵉⵏ ⴷ ⵢⵓⵜⵜⴰⵏ	والمراقبة تكون في بعض الحالات الخاصة والمحدودة
ⵙ ⵓⵎⴷⵢⴰ ⵍⵍⴰⵏ ⵡⴰⵏⴰⵡⵏ ⵏ ⵜⵎⵉⵊⵊⵉⵜⵉⵏ ⵉⵇⵇⴰⵏ ⴷ	على سبيل المثال هناك أنواع العطور يجب
ⵎⴰⵏⵎⴽ ⵜⵥⴹⴰⵕ ⴰⴷ ⵜⵙⴽⵔ ⴰⵎⵢⴰⵙ ⵏⵏⵙ ⴰⵎⵙⴰⴷⵓⵔ?	كيف يمكنها أن تحقق توازنها الغذائي؟
ⴰⵔⴷ ⵜⵥⴹⴰⵕⴷ ⴰⴷ ⵜⵍⴽⵎⴷ ⵜⴰⵢⴰⴼⵓⵜ	حتى تتمكن من الحصول على النتيجة
ⵣⵓⵏ ⴷ ⵜⴰⴷ ⵍⵍⵉ ⵙ ⴰⵔ ⵜⵙⵡⵓⵔⵉⵢⴷ	كهذه التي تشتغل بها
ⵏⴽⴽⵏⵉ ⴰⵔ ⴱⴰⵀⵔⴰ ⵏⵙⵡⵓⵔⵉⵢ ⴳ ⵓⵎⵣⴳⵓⵏ	نحن نعمل كثيرا في المسرح
ⴷ ⴰⴷ ⵜⵙⵙⴰⴷ ⴰⵜⴰⵢ ⵏⵖ ⵍⵇⵀⵡⴰ	وإحتساء الشاي أو القهوة
ⵏⴰⴼ ⵏⵏ ⵎⴰⵙ ⴷ ⴽⵓ ⵢⴰⵏ ⵙⴳⵉⵙⵏ ⵢⵓⵙⵉ ⵜⵉⵍⵉⴼⵓⵏ	و نجد بأن كل واحد منهم يمسك الهاتف
ⵉⵎⴰ ⵉⵔⴳⴰⵣⵏ	أما بالنسبة للرجال
ⴽⵓⴷⵏⵏⴰ ⵜⵜⴷⴷⵉⴷ ⵙ ⵜⵉⵏⵎⵍ ⵏⵖ ⵜⴰⵎⵍⴷⴰ ⵏ ⵜⵍⴰⵍⵉⵜ	عندما تذهب للمدرسة أو لعيد ميلاد
ⴰⵔ ⵜⵙⵎⵎⵜⴰⵔⴷ ⵎⴷⴷⵏ ⵏⵏⴰ ⴷⴰⵔⵎ ⵉⵙⵙⴰⵖⵏ ⴰⴷ ⵜⵏ ⵙⵙⵡⴰⵏ	تنصحين الناس الذين يشترون منك برشها
ⴳ ⵜⴳⵉⵡⵔⵜ ⴰⴷ ⵜⵓⴱⵖⵉⵔⵜ	في هذه الجلسة المفيدة
ⵎⴰ ⵙ ⵉⵎⵣⴰⵔⴰⵢ ⴷ ⵓⴼⵍⴰⵢ ⵏ ⵓⵙⵖⵓⴷⵓ?	بماذا تختلف عن الجراحة التجميلية؟
ⵉⵍⵍⴰ ⵖⴼ ⵓⴼⴳⴰⵏ ⴰⴷ ⵉⵍⵎⴷ	على الإنسان أن يتعلم
ⴰⴷ ⴰⵇⵇⵔⴰⵖ ⴰⴼⴰⴷ ⴰⴷ ⵉⵢⵉ ⵉⵜⵜⵙⵍⵍⴰ	أن أقرأ ليسمعني
ⵥⵕ ⵜ ⵣⵓⵏ ⵓⵔ ⵉⵍⵍⵉ	اعتبره كأن لم يكن
ⵏⵖ ⵉⴽⵯⵍⴰⵏ ⵏⵖ ⵎⵏⵏⴰⵡⵜ ⵜⵖⴰⵔⴰⵙⵉⵏ ⵢⴰⴹⵏⵉⵏ	أو إلى ألوان أو عدة طرق أخرى
ⵙⴽⵔⵖ ⴰⵙⵙⵓⴼⵖ ⴰⵏⵎⵣⴳⵓⵏ	قمت بالإخراج المسرحي
ⵎⴰⵛⵛ ⵉⵇⵇⴰⵏ ⴷ ⴰⴷ ⵜⵙⵡⵉⵏⴳⵎⴷ	ولكن يجب التفكير
ⵉⵍⵎⵎⴰ ⵏⵙⵎⵔⴽⵙ ⴰⵔⴽⴽⵉⵙ	ثم نقوم بمزج الخليط
ⵏⵖ ⵜⵉⴼⴰⴼⵉⵏ ⵜⵉⴽⴰⵏⵚⵉⵕⵉⵏ	أو الأورام السرطانية
ⵎⴰⵛⴰ ⵓⵔ ⴷⴰ ⴰⵙⵏ ⵉⵙⴽⴰⵔ ⴰⵏⴳⴰⵥ	لكنه لا يسبب الألم
ⴷ ⵜⵉⵣⵉ ⴰⵏⵏ ⵜⵥⴹⴰⵕⴷ ⴰⴷ ⴰⵙ ⵜⵉⵏⵉⴷ ⴰⴷ ⵜⵙⵙⴽⵛⵎⴷ ⵉⵡⵉⴽ ⵙ ⵉⵙⴳⵔⴰⵡⵏ	وحينها يمكنك أن تطلب منه أن يتم إدخال الطفل لأندية
ⴷ ⴷⴰⵔⵏⵖ ⵜⵉⵢⵢⴰⴹ ⵙ ⵜⵖⴰⵔⴰⵙⵉⵏ ⵉⵙⵎ ⵏⵏⵙⵏⵜ ⵜⴰⵡⵓⵔⵉ ⵏ ⵉⵎⵉⵏⴹ	ولدينا أخريات بطرق تسمى خدمة المعلم
ⵉⵍⵍⴰ ⴼⵍⵍⴰⵙⵏ ⴰⴷ ⵜ ⵙⵙⵏⴼⵍⵏ ⵙ ⵓⵙⵡⵉⵏⴳⵎ ⵓⵎⵏⵉⴳ	عليهم بتحويله إلى تفكير إيجابي
ⵜⴳⴰ ⴰⵙ ⵉⵥⵍⵉ	تعتبر فرعا لها
ⵍⵍⵉ ⴷⵉⵜⵉ ⵉⵍⵍⴰⵏ ⴰⵙⵙ ⴰⴷ ⴳ ⵜⴳⵟⵟⵓⵎⵜ ⵏ ⵜⴳⵎⵉ ⵜⴰⵏⵉⵎⴰⵏⵜ	الحاضر معي اليوم في فقرة التنمية الذاتية
ⵙⵍⴰⵡⴰⵏ ⵜⴰⵡⵊⴰ ⴷ ⵜⵉⵏⵎⵍ	خاصة الأسرة والمدرسة
ⵙⴳ ⵉⵙⵇⵙⵉⵜⵏ ⵍⵍⵉ ⵉⵜⵜⵉⵍⵉⵏ ⴳ ⵉⵔⵉⵎⵏ ⵏ ⵓⵙⵎⴰⵀⵍ ⴳ ⵜⵎⵙⵙⵓⵔⵉⵏ	من الأسئلة التي توجه في إمتحانات التوظيف في الشركات
ⴷⴰ ⵜⵣⵍⵍⵓ ⴰⵡⴷ ⴰⵏⵏⵖⵣⵍ ⵏ ⵜⵡⵓⵔⵉ ⴳ ⵜⴳⵎⵎⵉ ⴷ ⵓⵙⴳⵎⵉ ⵏ ⵜⴰⵔⵡⴰ	تفقد أيضا شغف العمل بالبيت وتربية الأبناء
ⵏⵜⵜⴰ ⵜⴼⵓⵍⴽⵉ ⵉ ⵡⵉⵏⵏⴰ ⴷⴰⵔ ⵜⵍⵍⴰ ⵜⵚⵎⴹⵉ	هي مفيدة لمن يعانون البرودة
ⵡⵉⴷ ⴰ ⵉⴳⴰⵏ ⵉⵙⵔⴰⴳⵏ ⵍⵍⵉ ⵉⵙⵔⵓⴳⵏ ⴰⵇⵇⵍⵜⵓ ⴳ ⵜⴳⵯⵎⵎⴰ ⵏⵏⵖ	هذه هي الأسباب التي تؤدي إلى الرطوبة في منازلنا
ⴰⵡⴷ ⴰⵙⵍⴰⴽ ⵉⴳⴰ ⵜⴰⵖⴰⵡⵙⴰ ⵜⵓⵎⵏⵉⴳⵜ	كذلك التنازل شيء إيجابي
ⵎⴰⵛⵛ ⵜⵥⴹⴰⵕ ⴰⴷ ⵜⵔⴷⵍ ⴰⵢⵍⵍⵉ ⴰⴽⴽⵯ ⵜⵥⴽⴰ ⵜⵡⵊⴰ	لكنها قد تهدم كل ما بنته الأسرة
ⴷⴰ ⵜⵜⵉⴳⵓⵜⵏⵜ ⵙⵍⵖⵏⵜ ⴷ ⵉⵍⴰⵡⴰⵏ	تتكاثر وتلتصق بالأمعاء
ⵏⵃⵙⴰ ⵉⵣⵍⴰⵏ	حفظنا الأغاني
ⴷ ⵙ ⵜⵎⵙⴽⵔⵜ ⴰⴷ ⴷⴰ ⵜⵣⵍⵍⵓⴷ ⴰⴽⵓⴷ ⵏⵏⴽ	و بهذا التصرف تضيع وقتك
ⴰⴷ ⴰⵙ ⵜⵙⵖⴷ ⵜⴰⵔⵔⴰⴳⵜ ⵏⵖ ⵜⵉⵀⵉⵔⵉⵜ ⵏⵖ ⴰⵎⴽⴽⴰⵍⵓ	أن تشتري له هدية أو سيارة أو شاحنة
ⴷ ⴰⴷ ⵉⵙⴽⵔ ⵜⵉⵖⴰⵡⵙⵉⵡⵉⵏ ⵢⴰⴹⵏⵉⵏ ⴰⴼⴰⴷ ⴰⴷ ⵉⵙⵙⵉⴷⵜ ⵉⵡⵜⵜⴰⵙⵏ ⵏⵏⵙ	والقيام بأمور أخرى لتحقيق أهدافه
ⵍⵍⵉⴳ ⴷⵉⵜⵏⵖ ⵜⵍⵍⵉⴷ ⴰⵙⵙ ⴰⴷ	على حضورك معنا اليوم
ⵎⴰⵏⵎⴽ ⵏⵜⵜⵙⵙⵏ ⵎⴰⵙ ⴷⴰⵔⵏⵖ ⴰⴹⴰⵕ ⵉⴳⴳⵯⴷⵔⵏ?	كيف نعرف أننا نعاني من الرجل المقعّرة؟
ⴷⴰ ⵜⵜⵉⵏⵉⵏ ⴼⴽ ⴰⴼⴰⴷ ⴰⴷ ⵜⴰⵎⵥⴷ	يقال أنفق لتكسب
ⵏ ⵉⴽⵎⴰⴹⵏ ⴷ ⵉⴽⴽⴰⵏ ⴰⵎⵍⴰⵍ ⵏ ⵢⵉⵍⵍ	لحروق ناتجة عن رمل البحر
ⴷⴰ ⵙⵙⴰⵖⵏ ⵜⵉⵙⵎⴰⵇⵇⴰⵍⵉⵏ ⵉⵎⵓⵜⵜⴳⵏ	يعمدون إلى شراء نظارات جاهزة
ⵏⵏⴰ ⵉⴳⴰⵏ ⴰⵡⴷ ⵉⵎⴰⵔⴰⵡⵏ ⴷⴰ ⴰⵇⵇⴰⵔⴰⵏ	وهي أن يكون الأبوين أيضا يطالعون
ⵉⵜⵜⵓⵙⵙⴰⵏ ⵎⴰⵙ ⴷ ⴰⵎⵣⴳⵓⵏ ⵉⴳⴰ ⴱⴰⴱⴰⵙ ⵏ ⵜⵥⵓⵕⵉ	معلوم المسرح أب الفنون
ⵙ ⵓⵎⴷⵢⴰ ⴳ ⵡⴰⴷⴷⴰⴷ ⵏⵏⵎ ⵔⴰⴷ ⵜⵉⵏⵉⴷ	مثلا في حالتك ستقولين
ⵏⵙⵎⵓⵜⵜⴳ ⴰⴹⴱⵚⵉⵍ ⵏ ⵓⵙⵏⴽⴷ	نحضر صحن التقديم
ⵙⵎⵓⵏⵖ ⵜⵏⵜ ⵎⵍⵉⵃ	أجمعهما بإحكام
ⵉⴳ ⴷⴰ ⴽⴽⴰⵜⵖ ⵉⵡⵉ ⵉⵇⵇⴰⵏ ⴷ ⴰⴷ ⴱⴷⴷⵖ	إن كنت أضرب ابني فيجب أن أتوقف
ⵍⵍⵉ ⴳ ⴽⵚⵓⴹⵏⵜ ⵜⵎⵖⴰⵔⵉⵏ ⴰⴷ ⵉⵙⴳⵉⵏⵏ ⵡⵓⴷⵎⴰⵡⵏ ⵏⵏⵙⵏⵜ	حيث تخشى النساء أن تسود وجوههن
ⴷ ⵓⵏⵎⴳⴰⵍ ⵙ ⵓⵏⵎⴳⴰⵍ, ⴰⵛⴽⵓ ⴰⵢⴰⵏⵏ ⵉⵎⵎⵣⴷⵉ ⴽⵉⴳⴰⵏ	والعكس بالعكس، لأن ذلك مرتبط بشدة
ⴳ ⵙⵙⵓⵙ ⵔⴰⴷ ⵏⴰⵙⵔ	بالنسبة للصلصة سنحتاج
ⵏⵙⵎⵔⴽⵙ ⴰⵔⴽⴽⵉⵙ ⵢⴰⵏ ⵉⵎⵉⴽⴽ	نقوم بمزج الخليط بعض الشيء
ⴷ ⵎⴰⵙ ⴷ ⵉⴹ ⵢⵓⵙⵉ ⴷⵉⵙ ⵉⵎⵉⵣⵉⵜⵏ	وأن الليل يحمل معه المخاطر
ⵏⵖ ⵜⵉⵙⴳⵉⵡⵉⵏ ⵙ ⵙⵏⴰⵜ	أو الجهتين معا
ⴰⵛⴽⵓ ⵡⴰⵍⵍⵉ ⵜ ⵉⵙⴽⵔⵏ ⵓⵔ ⵉⴹⴼⵉⵕ ⵉⴱⵔⵉⴷⵏ ⵉⵎⵉⴷⵉⵢⵏ ⵏⵏⵙ	لأن من قام به لم ينتهج السبل الصحيحة لذلك
ⵙⵡⴰ ⴳⵯⵎⴰ ⵏⵖ ⵓⵍⵜⵎⴰ ⵏⵖ ⵉⵎⵎⵉ ⵏⵖ ⴱⴰⴱⴰ	سواء أخ أو أخت أو أم أو أب
ⴷⴰ ⵜⴻⵜⵜⴰⵍⵉ ⵜⵎⵏⵛⴽⵜ ⵏ ⵓⵙⵎⴻⵎ ⵏ ⵢⵓⵔⵉⴽ ⴳ ⵉⴷⴰⵎⵎⵏ	تكون نسبة حمض اليوريك مرتفعة في الدم
ⴰⴼⴰⴷ ⴰⴷ ⵜ ⵏⵙⵙⵉⵣⴷⴳ ⵎⵍⵉⵃ	لتنظيفه نهائيا
ⴷⴰ ⵏⵙⴽⴰⵔ ⴰⵙⵖⵉⵡⵙ ⴰⴷ ⴳ ⵜⵖⴰⵡⵙⵉⵡⵉⵏ ⵜⵉⴼⵔⴰⵔⵉⵏ	نقوم بهذا التخطيط في الأمور البسيطة
ⴽⵓⴷⵏⵏⴰ ⵜⵙⴳⵔⴰⵡⵍⴷ ⵉⴼⴰⵙⵙⵏ ⴷⴰ ⴷ ⵉⵜⵜⴰⴳⴳⵯⴰ ⵏⴰⵃⵢⴰ ⵙⴳ ⵓⴳⵏⵙⵓ	حين تقلب الأكمام يظهر مختلفا من الداخل
ⴰⴼⴰⴷ ⴰⴷ ⵥⴹⴰⵕⵏ ⴰⴷ ⴽⵏⵏ ⵜⵓⵇⵇⵏⵉⵡⵉⵏ ⵏⵏⵙⵏ ⴳ ⵕⵎⴹⴰⵏ	لكي يتمكنوا من إصلاح علاقاتهم في رمضان
ⵏⵉⵏⵉ ⵙ ⵜⵎⴰⵣⵉⵖⵜ ⵔⵉⵖ ⴰⴷ ⴳⴰⵡⵔⵖ ⴷ ⵢⵉⵖⴼ ⵉⵏⵓ	و نقول بالأمازيغي أريد أن أختلي بنفسي
ⵉⵍⵎⵎⴰ ⵏⵔⵏⵓ ⴰⴽⵯⴼⴰⵢ ⵢⵓⵣⵖⵏ	ثم نضيف الحليب المجفف
ⴰⵔⴷ ⵏⵉⵥⴹⵉⵕ ⴰⴷ ⵏⵙⵔⵙ ⴰⵔⴽⵜⵓ ⵖⵉⴷ	حتى يتسنى لنا وضع العجين هنا
ⴰⴷ ⴰⵙ ⵜⵣⵣⵔⴰⵢⴷ ⵜⵉⴱⵔⴰⵜⵉⵏ ⴰⴼⴰⴷ ⴰⴷ ⵉⵍⵎⴷ ⴰⴷ ⵉⵙⵔⵓⵙ ⵜⵉⵙⵏⵏⵙⴰⵔ ⵉ ⵡⵉⵢⵢⴰⴹ	تمرر له الرسائل ليتعلم بأن يلتمس العذر للآخرين
ⴰⵢⴰⴷ ⴳ ⵜⵉⴷ ⵉⵜⵜⵓⴽⵍⴰⵏ	هذا بالنسبة للملونة
ⵙ ⵜⵉⴷⵜ ⴽⵓⴷⵏⵏⴰ ⵉⵙⴽⴰⵔ ⵜⵓⵏⵏⵓⵏⵜ ⵓⵔ ⵉⵜⵜⴰⴹⵏ ⴰⵡⵔⵣ ⵏ ⵓⴹⴰⵕ ⵏⵏⵙ	بالفعل عندما يمارس الرياضة لن يؤلمه كعب قدمه
ⴷ ⴰⵔ ⵙⵓⵍ ⵙⵇⵙⴰⵏ ⵖⴼ ⵉⴳⵣⵎⴰⵏ ⵢⴰⴹⵏⵉⵏ ⵏⵏⵙ	ولا يزالوا يتساءلون حول أجزاء أخرى منها
ⴳ ⵉⵙⵎⵓⵜⵜⵓⴳⵏ ⵏ ⵜⴼⵓⴳⵍⴰ ⴰⴼⴰⴷ ⴰⴷ ⵜⵉⵍⵉ ⴳ ⵓⵙⵡⵉⵔ ⵍⵍⵉ ⵏⵔⴰ	في تحضيرات الحفل ليكون بالمستوى المطلوب
ⴷ ⵔⴰⴷ ⵏⵙⵏⴱⴳⵉ ⵖⵉⵍⴰ ⵢⴰⵜ ⵜⵎⵖⴰⵔⵜ ⵜⵍⵙⴰ ⴰⵇⴼⵟⴰⵏ	وسنستقبل الآن سيدة ترتدي القفطان
ⴳ ⵜⵡⵓⵔⵉ ⴷⴰ ⵜⴻⵜⵜⴰⴼⴰ ⵜⴼⵔⵓⵅⵜ ⵉⴳⵉⵢ ⴷ ⵓⵥⵍⴰⵢ	في العمل تتعرض فتاة إلى الرفض والإقصاء
ⴰⵎⴰⵣⵣⴰⴳ ⴳ ⵜⵎⵙⴰⴷⵓⵔⵜ	المتخصص في التغذية
ⵙⵙⵉⵎⵙⵉⵎ ⴷ ⵜⵎⵉⵎⵉⵏ ⵉⵖⵎⴰⵏ	السمسم والحلوى الملونة
ⵏⵍⴽⵎ ⴰⴷⵍⴰⴳ ⴰⴷ	نحصل على هذا الديكور
ⵖⵉⴷ ⴰⵔ ⵏⵜⵜⵉⵏⵉ ⵎⴰⵙ ⴷ ⴰⴼⴳⴰⵏ ⴷⴰⵔⵙ ⴰⵣⵎⵣⵔ ⴳ ⵜⴰⵡⵏⴰ	هنا نقول أن الشخص يعاني من تشتت التركيز
ⴷ ⴰⵏⴷⵓⵏⵉⵙⵢⴰ ⴷ ⵍⵀⵉⵏⴷ	و أندونيسيا والهند
ⵜⴰⴷ ⴰ ⵉⴳⴰⵏ ⵜⴰⴳⴷⴰ ⵏ ⵓⵇⵇⵍⵜⵓ ⵢⵓⴼⵏ ⴳ ⵜⵎⴷⵉⵏⵉⵏ ⵉⵍⵍⴰⵏ ⵖⴼ ⵢⵉⵍⵍ	هذه هي معادلة الرطوبة الأفضل في المدن الساحلية
ⴰⵛⴽⵓ ⴽⵔⴰ ⵏ ⵜⴽⴽⴰⵍ ⴷⴰ ⵏⵥⵕⵕⴰ ⵎⴰⵢⴷ ⴷⴰⵔ ⵢⴰⵏ ⵡⴰⴷⴷⴰⴷ ⴰⵏⵉⵎⴰⵏ	ففي بعض الأحيان نرى من يعاني حالة نفسية
ⴷⴰ ⵏⵜⵜⴰⴼⴰ ⴰⵄⵔⵔⵉⵎ ⴰⵔ ⵉⵙⴰⵡⴰⵍ ⵙ ⵜⴼⵙⵙⴰ ⴷ ⵜⵓⴳⵜⵜ ⵏ ⵜⵎⵙⵙⵏⴰ ⴰⵢⴰⴷ ⵉⴽⴽⴰ ⴷ ⵜⵉⵖⵔⵉ	نجد الشاب يتكلم بطلاقه والكثير من العلم السبب في هذا هو القراءة
ⵙ ⵡⴰⵏⴰⵡⵏ ⵏⵏⵙ ⴰⴽⴽⵯ	بكل أنواعها
ⴳ ⵓⵏⵛⵜ ⵏ ⵓⵙⵜⴰⵢ ⵏ ⵓⵎⵙⴰⵖ	حسب إختيار الزبون
ⵢⴰⵎⵥ ⵜⵜ ⵎⵇⵇⴰⵔ ⴰⴽⵓⴷ ⵍⵍⵉ ⵜⴻⵜⵜⵉⵔⵉ	وإكتسابها بالرغم من الوقت الذي تتطلبه
ⴳⴰⵏ ⵉⵔⵉⵎ ⵙⴳ ⴷⴰⵔ ⵕⴱⴱⵉ, ⴰⴼⴰⴷ ⴰⴷ ⴰⴽ ⵉⵙⵙⵍⵎⴷ ⴽⵔⴰ ⵜⵖⴰⵡⵙⴰ	هي إمتحان من الله ليعلمك شيئا معينا
ⵉⵎⵛⴰⵛⴽⴰⵏ ⴷ ⵓⵙⵖⴰⵍ ⵏ ⵓⴹⴰⵕ	يناسب مقاس الرجل
ⴷⴰ ⵏⵏ ⵏⵜⵜⴰⴼⴰ ⴽⵔⴰ ⵏ ⵡⵉⵍⵍⵉ ⵉⵙⵙⵎⵔⴰⵙⵏ ⵉⵡⴰⵍⵉⵡⵏ ⵉⵎⵎⴰⵍⵏ ⵎⴰⵙ ⵓⵔ ⴷⴳⴳⵉⵏ ⴰⵎⵣⴰⵔⴰⵢ	نجد البعض يستعملون ألفاظا تظهر أنهم لا يتقبلون الإختلاف
ⵉⴳⴰⵏ ⴰⵙⴰⴼⴰⵔ ⵏ ⵡⴰⵟⵟⴰⵏ ⴰⴷ ?	كعلاج لهذا المرض ؟
ⵏⵏⵉⵖ ⴰⵙⵏ: ⴰⵛⴽⴰⵜ ⴷ ⵜⴰⵡⵉⵎ ⵉⵢⵉ ⵏⵏ	قلت لهم: تعالوا لأخذي
ⴰⵏⵎⵓⵇⵇⴰⵔ ⵏⵏⵖ ⴳ ⵜⴳⵟⵟⵓⵎⵜ ⴷ ⵢⵓⵛⴽⴰⵏ	لقاؤنا يتجدد في الفقرة المقبلة
ⵉⵍⵍⴰ ⴷⴰ ⵜⵏ ⴱⴷⴷⴰ ⵙⵎⵎⵜⴰⵔⵖ ⵖⴼ ⵡⴰⵔⴰⵢ	لهذا أنصحهم دائما بالوقاية
ⴳ ⵜⴳⵉⵔⴰ ⵏⵔⵏⵓ ⴰⴱⵔⵙⵙⵉ	وأخيرا نضيف الجبن
ⵉⵍⵍⴰ ⴼⵍⵍⴰⴽ ⴰⴷ ⵜⵎⵙⴼⴰⵔⴰⴷ, ⵜⵎⵙⴰⵔⵓⴼⴷ	عليك أن تكون متصالحًا متسامحًا
ⵍⵍⵉ ⴳ ⴷⴰ ⵏⵜⵜⵎⴰⵜⴰⵔ ⵜⵉⴱⵔⴰⵜⵉⵏ ⵍⵍⵉ ⴷ ⵉⵜⵜⴽⴽⴰⵏ ⴷ ⵍⵍⵉ ⴷ ⵉⵜⵜⵢⴰⵣⴰⵏⵏ ⵙⴳ ⵜⴳⵔⵔⴰⵡⵜ	حيث نراقب الرسائل الواردة والمبعوثة إلى العقل
ⵖⵉⴷ ⴷⴰ ⵜⵜⵕⵥⴰⵎⵖ ⵜⴰⴳⴳⵓⵔⵜ ⴰⴷ ⵉⵢⵉ ⵢⴰⵍⵙ ⵜⵉⵖⴰⵡⵙⵉⵡⵉⵏ ⵍⵍⵉ ⵓⵔ ⵢⴰⴷⵍⵍⵉ ⵉⵔⵉ ⴰⴷ ⵜⵏⵜ ⵢⵉⵏⵉ	هنا أفتح الباب ليخبرني بأشياء لم يكن يود قولها
ⵎⴰⵏⵉ ⴳ ⵉⵜⵜⵉⵍⵉ ⵓⵏⴳⴰⵥ?	أين يكون الألم؟
ⴷ ⴰⵛⴽⵓ ⵕⵎⴹⴰⵏ ⴷⴰⵔⵙ ⴰⵣⴰⵍ ⴰⵅⴰⵜⴰⵔ	ولأن رمضان ذو أهمية كبيرة
ⴷ ⵢⴰⵜ ⵜⵎⵖⴰⵔⵜ ⵜⵏⵏⴰ ⵓⵔⴳⴰⵣ ⵏⵏⵙ, ⵏⴽⴽⵉ ⴷⴰ ⵥⵕⵕⴰⵖ ⵎⴰⵙ ⴷ ⴰⵢⵜ ⴷⴰⵔⴽ	فزوجة قالت لزوجها إني أرى أهلك
ⴽⵔⴰ ⴳⵉⵙⵏⵜ ⵉⵜⵜⵢⴰⵔⴰ ⴳ ⵉⵣⴷⴰⵔ	بعضها يكون مكتوبا في الأسفل
ⴳ ⵜⵖⴰⵔⴰⵙⵜ ⵏ ⵡⵓⵜⵛⵉ ⴷ ⵡⴰⴽⵓⴷ ⵏⵏⵙ ⴷ ⵓⵏⵛⵜ ⵏⵏⵙ	في طريقة الأكل وتوقيته وكميته
ⵏⵙⵔⵙ ⵉⴹⵓⴹⴰⵏ ⵖⵉⴷ ⴷ ⵏⵙⵎⵓⵏ ⵜ	نضع الأصابع هنا ونجمعه
ⵉ ⵡⴰⵏⵏⴰ ⵉⵣⵡⴰⵏ ⴷⴰ ⵜ ⵏⵙⵙⵎⵔⴰⵙ ⴽⵕⴰⴹⵜ ⵜⴽⴽⴰⵍ ⴳ ⵉⵎⴰⵍⴰⵙⵙ	للجاف نستعمله 3 مرات في الأسبوع
ⴰⵙⵔⴰⴳ ⵉⴳⴰ ⵜ ⵓⴹⵉⵡ ⴰⵎⴳⵔⵔⴰⵡ	السبب هو الشرود الدهني
ⵉⵎⵓⵙⵙⵓⵜⵏ ⵎⵇⵇⴰⵔ ⴳⴰⵏ ⵜⵓⵏⵏⵓⵏⴰⵏⵉⵏ ⴷ ⵜⴷⵍⵙⴰⵏⵉⵏ ⴷ ⵜⵥⵓⵕⴰⵏⵉⵏ ⴷ ⵜⵡⵏⴹⴰⵏⵉⵏ	التظاهرات بالرغم من أنها رياضية أو ثقافية أو فنية أو بيئية
ⵏⵣⵣⵔⵉ ⵜⵉⴳⵍⴰⵢ ⵉⴳⴳⵉ ⵏⵏⵙ ⵙ ⵉⵎⴽⴰ	نمرر البيض فوقها هكذا
ⴷ ⵉⵖⵉⵢ ⴰⴷ ⵉⴳ ⴰⵎⴰⴷⵓⵏ ⵉⵣⵡⴰⵏ ⵙ ⵢⴰⵜ ⵜⴽⴽⵍⵜ	وقد تكون دهنية وجافة في الآن ذاته
ⴷ ⵙⴳⵉⵙⵏⵜ ⵜⴰⵖⴰⵡⵙⴰ ⵏⵏⴰ ⵏⵜⵜⴰⵡ ⴽⵉⴳⴰⵏ	ومنها أمر نتغافل عنه كثيرا
ⴷ ⴷⴰ ⵜⵙⵔⵓⴳ ⴳ ⵓⵏⵓⵙⵔⵓ ⵏ ⵜⵎⵏⵛⴽⵜ ⵏ ⵓⵙⴽⴽⵯⴰⵔ ⴳ ⵉⴷⴰⵎⵎⵏ ⵣⵉⴽ	وتؤدي إلى خفض نسبة السكر في الدم مبكرا
ⵣⵓⵏ ⴷ ⵉⵙⴼⵙⴰⵔ ⵙ ⵜⵎⴰⵣⵉⵖⵜ ⴷ ⵣⵓⵏ ⴷ ⵉⵎⴽⴰⵏⵏ	كالعروض بالأمازيغية ونحوها
ⵎⴰⵛⵛ ⵎⴰ ⵖⴼ ⵏⴻⵏⵏⵓⵎⵎⵙ ⵖⴼ ⵜⵎⵖⴰⵔⵉⵏ	لكن لماذا ركزنا على النساء
ⴷ ⵎⴰ ⵉⴳⴰⵏ ⴰⵙⴳⵎⴰⵏ ⴷ ⵎⴰ ⵉⴳⴰⵏ ⴰⵡⵏⵏⴰⴹⴰⵏ	وما هو تربوي وما هو بيئي
ⵙⵍⴰⵡⴰⵏ ⴰⴽⴽⵯ ⴷⴰⵔ ⵎⴷⴷⵏ ⵉⵣⵔⵉⵏ 50 ⵏ ⵓⵙⴳⴳⵯⴰⵙ	خصوصا لدى الأشخاص الذين تتجاوز أعمارهم 50 سنة
ⴰⴼⴰⴷ ⴰⴷ ⵏⵥⵕ ⵜⵉⵔⵎⵜ ⵍⵍⵉ ⵔⴰⴷ ⵉⵙⵎⵓⵜⵜⴳ	لنرى الطبق الذي سيحضره
ⵎⴰⵢⴷ ⵉⵙⴽⵔ ⵓⵙⴰⴽⵯⵏ ⴰⵎⵥⵢⴰⵏ?	ماذا فعل المصنع الصغير؟
ⴰⵙⵍⵎⴰⴷ ⵓⵃⵙⴰⵢⵏ ⴷⴰ ⵏⵥⵕⵕⴰ ⴽⵔⴰ ⵏ ⵎⴷⴷⵏ ⵓⵔ ⵥⴹⵉⵕⵏ ⴰⴷ ⵉⵏⵉⵏ "ⵓⵀⵓ"	أستاذ أحساين نرى بعض الناس لا يستطيعون قول "لا"
ⵏⵙⵎⵔⴽⵙ ⵖⵉⵍⴰ ⵙⴰⵏⵉⴷⴰ ⴷ ⵜⵎⵓⴷⵉⵜ	سنقوم الآن بمزج السكر مع الزبدة
ⵍⵍⵉⴳ ⴷⴰⵔⵙ ⵓⵔ ⵜⵍⵍⵉ ⵜⴼⵍⵙⵜ ⴳ ⵢⵉⵖⴼ ⵏⵏⵙ ⴷ ⵓⴳⵍⵓⴳⵍ ⵏⵏⵙ	بسبب خوفه وإنعدام ثقة في نفسه وتردده
ⴰⵙⵙ ⴰⴷ ⵏⴽⴽⵏⵉ ⴷⴰⵔ ⵎⴰⵙⵙ ⵀⵉⵛⴰⵎ, ⴰⵎⵙⵖⵉⵡⵙ ⵏ ⵉⴷⵍⴰⴳⵏ	اليوم نحن عند السيد هشام، مصمم الديكور
ⵙⵙⵏⴼⵍⵏ ⵜⴰⵎⵙⵙⵓⵔⵜ ⴽⵓ ⵚⴹⵉⵚ ⵢⵉⵔⵏ	يغيرون الشركة كل ستة أشهر
ⴷ ⵏⴽⴽⵏⵉ ⵏⵔⴰ ⴰⴷ ⵏⵃⴹⵓ ⵜⴰⴷⵍⵙⴰ ⵏ ⵓⵙⵙⴼⵍⴷ ⵉ ⵜⵏⵣⵡⴰⵢⵜ	ونحن نرغب في الإحتفاظ بثقافة الإستماع إلى الإذاعة
ⴷⴰ ⵉⵜⵜⴰⵡⵣ ⴽⵓ ⴰⵙⵙ ⴷ ⵓⵔ ⴷⴰ ⵉⵛⵜⵜⴰ ⵜⵉⵔⴰⵎ ⵏⵏⵙ ⵢⵓⴷⴰⵏ	يسهر يوميا ولا يتناول وجباته الكافية
ⴷⴰ ⴷ ⴰⴽⴽⵯ ⵜⵜⵎⵛⴰⵛⴽⴰⵏ ⴷ ⵉⵏⵡⴰⵍⵏ	كلها تناسب المطابخ
ⵉⵥⴹⴰⵕ ⴰⴷ ⵉⵏⴼⵍ ⵉⴳ ⵉⴳⵓⴼⵙⴰ	يمكن أن يغير إذا ما فسد
ⵎⴰⵛⵛ ⵜⴰⵎⵖⴰⵔⵜ ⵓⵔ ⴷⴰ ⵜⵜ ⴳⵉⵙⵏⵜ ⵜⴻⵜⵜⴰⵡⵉ	إلا اأن المرأة لا تعيرها أي إهتمام
ⵎⴰⵛⴰ ⴰⵙⵏⴼⵍ ⵉⵍⵍⴰ ⵙ ⵜⵙⴽⵯⴼⴰⵍ ⴰⵔⴷ ⵉⵥⵕ ⵜⵉⴼⴰⵡⵜ	أما التغيير فهو تدريجي حتى يرى النور
ⵖⵉⵍⴰ ⴰⴷ ⵏⴼⵜⵓ ⴷⴰⵔ ⵉⵏⴱⴳⵉⵡⵏ ⵏⵏⵖ ⵜⴰⴷⵓⴽⵜⵓⵔⵜ ⴰⵎⵉⵏⴰ ⴰⵢⵜ ⵙⵉⴷⵉ ⵄⵍⵉ	الآن نمر إلى الحاضرين معنا الدكتورة أمينة أيت سيدي علي
ⵉⴳ ⵓⵔ ⵏⵙⴽⵉⵔ ⵜⵉⵇⵇⵙⵜ ⵏⵖ ⵜⴰⵖⴰⵡⵙⴰ ⵢⴰⴹⵏⵉⵏ	إن لم نقم بالوخز أو شيء اخر
ⴷⴰ ⵙⵙⵏⵜⴰⵢⵏ ⴳ ⵓⵙⵎⵓⵎⵎⵉ	يبدأون في الشكوى
ⵜⴳⴰ ⴽⵓⴷⵏⵏⴰ ⵉⵔⵎⵙ ⵓⴼⴳⴰⵏ ⵎⴰ ⵙ ⴷⴰ ⵉⵙⵢⴰⴼⴰ ⴷ ⵎⴰ ⵙ ⴷⴰ ⵙⵢⴰⴼⴰⵏ ⵡⵉⵢⵢⴰⴹ	هو حين يفهم المرء ما يحس به وما يشعر به الآخرون
ⴷ ⵉ ⵓⵙⴽⵙⴼ ⵓⴳⴳⴰⵔ	وللتزيين أكثر
ⵔⴰⴷ ⵏⵙⴰⵡⵍ ⵖⴼ ⵓⵎⴰⵜⵔ	سوف نتحدث عن المراقبة
ⵉⵖⵏⴰ ⴰⵖ ⵕⴱⴱⵉ ⵏⵎⵣⴰⵔⴰⵢ ⵓⵔ ⵏⵎⵎⵔⵡⴰⵙ	خلقنا الله مختلفون لا نتشابه
ⴰⴼⴰⴷ ⴰⴷ ⵉⴽⵜⵓⵔ	لكي يصبح ممتلئا
ⵢⴰⵀ, ⴽⵔⴰ ⵏ ⵜⵎⵉⵊⵊⵉⵜⵉⵏ ⴷⴰ ⵜⵏ ⵙⵙⵎⵔⴰⵙⵏ ⵉⴳⵏⵓⵙⵏ ⵙ ⵙⵉⵏ	نعم، فبعض العطور تستعمل لكلا الجنسين
ⴷ ⴰⵔ ⵙⵏⵉⵎⵎⵉⵔⵖ ⵜⴰⵙⵍⵎⴰⴷⵜ ⴰⵎⵉⵏⴰ ⵙⴰⴳⵓ	و أشكرك أستاذة أمينة ساكو
ⴰⴼⴰⴷ ⴰⴷ ⵢⴰⴹⴼⵓⵜ ⵓⵎⴹⴰⵢ ⵏⵏⵙ	لكي يكون مذاقها لذيذا
ⵙⵍⴰⵡⴰⵏ ⴰⴽⴽⵯ ⴷ ⵜⴳⴰⵛⵓⵔⵜ ⵍⵍⵉ ⵉⵣⴷⵉⵏ ⴷ ⵢⵉⴳⵔ ⴰⴷ	خاصة مع العشوائية التي يتسم بها هذا المجال
ⵜⴰⵙⵙⴰⵙⵉⵏ ⵏ ⵜⵍⴼⴷⴰⵏⵜ ⴷⴰ ⴷ ⵜⵜⵏⴼⵍⴰⵍⴰⵏⵜ ⴳ ⵜⵉⵣⵉ ⴰⵏⵏ	فأزمات النقرس تلاحظ في تلك الفترة
ⵢⵉⵍⵉ ⴷⴰⵔⵙ ⴰⵡⴷ ⴰⵎⵓⴽⵔⵉⵙ ⵏ ⵡⵓⵍ	و يعاني أيضا من مشكل القلب
ⴰⵛⴽⵓ ⵍⵍⴰⵏⵜ ⵜⵖⴰⵡⵙⵉⵡⵉⵏ ⵜⵉⴼⵔⴰⵔⵉⵏ	لأن هناك أمور بسيطة
ⴳ ⵜⵊⵍⵍⵓⴱⴰ ⴰⴷ, ⴷⴰ ⵜⴻⵜⵜⴰⴼⴰⴷ ⴽⵔⴰ ⴳⵉⵙⵏⵜ ⵜⵉⵎⵅⵣⴰⵏⵉⵢⵉⵏ ⴷ ⵜⵉⵢⵢⴰⴹ ⴽⵕⵕⵓⵥⵏⵜ	في هذه الجلابيب تجيدين بعضها مخزنية وأخرى ضيقة
ⴰⵛⴽⵓ ⴷⴰ ⴰⵖ ⵜⵜⴰⵡⵙⵏ	لأنهم يساعدوننا
ⴹⴰⵕⴰⵜ ⵏ ⵜⵙⵙⴰⵏⵓⵏⵜ, ⵉⵇⵇⴰⵏ ⵓⵙⵡⵓⵏⴼⵓ, ⴷ ⴰⴷ ⵓⵔ ⵉⵜⵜⴱⴷⴰⴷ ⴱⴰⵀⵔⴰ	بعد الترويض تلزم الراحة وتجنب الوقوف طويلا
ⵙ ⵜⵖⴰⵔⴰⵙⵜ ⵏⵏⴰ ⵙ ⵔⴰⴷ ⵉⵢⵉ ⵉⵔⵎⵙ	بالطريقة التي سيفهمني بها
ⴰⴷ ⵏⵎⵎⴰⵇⵇⴰⵔ ⴳ ⵜⴳⵟⵟⵓⵎⵜ ⵢⴰⴹⵏⵉⵏ	نلتقي في فقرة أخرى
ⴽⵔⴰ ⵏ ⵎⴷⴷⵏ ⴷⴰ ⵜⵜⵖⴹⴰⴼⵏ ⵜⴰⵢⴰⴼⵓⵜ ⵙⴳ ⵜⴳⵉⵡⵔⵜ ⵜⴰⵎⵣⵡⴰⵔⵓⵜ	بعض الأشخاص يلاحظون النتيجة منذ الجلسة الأولى
ⵉⵎⴽⵍⵍⵉ ⵜⴹⴼⵕⵎ ⵏⵙⴰⵡⵍ ⵖⴼ ⵓⴼⵙⵙⴰⵢ ⵏ ⵉⵎⵓⴽⵔⵉⵙⵏ	كما تابعتم تحدثنا عن حل المشكلات
ⴷ ⵡⴰⵜⵉⴳ ⵏⵏⵙ ⵉⵍⵍⴰ ⴳ ⵓⴼⵓⵙ	كما أن ثمنها بالمتناول
ⵉ ⵉⵏⵍⵎⴰⴷⵏ ⵉⵍⵓⵖⵎⴰ ⴰⴷ ⵜⵏ ⵙⴽⵔⵏ ⴳ ⵜⴳⵎⵎⵉ	للتلاميذ واجبات يقومون بها في المنزل
ⴰⵛⴽⵓ ⴰⵏⵍⵍⵉ ⴰⵢⴷ ⵉⵜⵜⵏⴱⴰⴹⵏ	لأن الدماغ هو من يتحكم
ⵙⴳⵉⵙⵏ ⵎⴰ ⵉⴳⴰⵏ ⴰⵙⴳⴷⴰⵏ ⵣⵓⵏ ⴷ ⵍⵉⵙⵍⴰⵎ ⴷ ⵜⵎⴰⵙⵉⵃⵉⵜ ⵏⵖ ⵜⴰⴱⵓⴷⵉⵜ	منها ما هو ديني كالإسلام والمسيحية أو البوذية
ⴷ ⵓⵔ ⴷⴰⵔⵙⵏ ⴽⵔⴰ ⵏ ⵜⵙⴽⵔⴰⵡⵉⵏ ⵏⵖ ⴰⵎⵓⵔⵙ	وليس لديهم أي إنجاز أو نجاح
ⵉⴳ ⵓⵔ ⵉⵥⵥⵓⵍ ⵔⴰⴷ ⵉⵢⵉ ⵉⵙⴹⵕ ⴳ ⵉⴱⴽⴽⵉⴹⵏ	إن لم يصلّ سيوقعني في الذنوب والمعاصي
ⵉⵇⵇⴰⵏ ⴷ ⵏⵙⵓⵍ ⴳ ⵓⵙⵙⴰⵏⵓⵏ	لابد من الإستمرار في الترويض
ⴰⴷ ⴽⴰ ⵉⵙⵢⴰⴼⴰ ⵓⴼⴳⴰⵏ	فبمجرد شعور الشخص
ⵍⵍⵉ ⴳ ⴷⴰ ⵢⴰⴽⴽⴰ ⵜⵉⵢⴰⴼⵓⵜⵉⵏ ⵉⴼⵓⵍⴽⵉⵏ	حيث يعطي نتائج جيدة
ⵉⴳ ⵓⵔ ⵉⴼⵜⵉ ⵓⵎⴰⴹⵓⵏ ⴷⴰⵔ ⴰⵎⵙⴳⵏⴰⴼ	إذا لم يتوجه المريض إلى الطبيب
ⴽⵓⴷⵏⵏⴰ ⵜⵙⵙⵓⵜⵔ ⵜⵎⵖⴰⵔⵜ ⴰⵙⵓⵔⴼ ⵉⵍⵍⴰ ⴼⵍⵍⴰⴽ ⴰⴷ ⵜ ⵜⴷⴳⴳⵉⴷ	حين تعتذر الزوجة عليك قبول ذلك
ⴷ ⵉⵇⵇⴰⵏ ⴷ ⴰⴷ ⵏⵖⴰⵎⴰ ⵖⴼ ⵓⵢⵍⵍⵉ ⴰⴽⴽⵯ ⵏⵙⴽⴰⵔ,	ويجب المواظبة على كل ما نمارسه،
ⴰⵢⴰⴷ ⵉⵏⵜⵉ ⴷ ⵜⵎⵙⵙⵓⵔⵉⵏ	هذا بدأ مع الشركات
ⵏⵏⴰ ⵢⵓⵙⵔⵏ ⵜⴰⵡⵏⴰ ⵢⴰⵜⵜⵓⵢⵏ	الذي يحتاج لتركيز عال
ⵉⴳ ⵜⵥⵕⴰⵎ ⴰⵔ ⵉⴼⵙⵙⵉ ⴳ ⵜⵙⴳⵉⵡⵉⵏ	إذا لاحظتم فإنه يذوب في الجنبات
ⵜⴰⴳⵔⴰⵖⵍⴰⵏⵜ ⵣⵓⵏ ⴷ ⵀⴰⵔⴼⴰⵔⴷ	دولية مثل هارفرد
ⵃⵎⴰ ⴰⴷ ⴷⴰⵔⵙⵏ ⵜⵉⵍⵉ ⵜⴷⵍⵙⴰ	لتكون لديهم ثقافة
ⵔⴰⴷ ⵏⵙⴰⵡⵍ ⴰⵙⵙ ⴰⴷ ⵖⴼ ⵜⵎⵍⵉⵍⵜ ⵏ ⵜⵎⵖⴰⵔⵜ ⴷ ⵜⵎⵙⵜⴳⴳⴰⵔⵜ ⵏⵏⵙ ⵜⴰⵡⵊⴰⵡⴰⵏⵜ	سنتحدث اليوم عن دور المرأة ومسؤوليتها الأسرية
ⵏⵥⴹⴰⵕ ⴰⴷ ⵜ ⵏⵙⴽⵙⴼ ⵙ ⵉⴼⵔⴷⵉⵙⵏ ⵍⵍⵉ ⴷⴰⵔⵏⵖ ⴳ ⵜⴳⵎⵎⵉ	بإمكاننا تزيينه بالمكونات التي نتوفر عليها في المنزل
ⴰⵙⵍⵎⴰⴷ ⴰⵙⵙ ⴰⴷ ⵔⴰⴷ ⵏⵙⴰⵡⵍ ⵖⴼ ⵡⴰⴽⴰⵎ ⴰⵏⵉⵎⴰⵏ	أستاذ اليوم سنتحدث اليوم عن التحفيز الذاتي
ⴱⵍⴰ ⵜⵜ ⵢⵉⵡⵉ ⴳ ⵜⴰⵏⵏⴰⵢⵉⵏ ⵏ ⵡⵉⵢⵢⴰⴹ	من دون الإهتمام بآراء الآخرين
ⵜⴰⵡⵍⴰⴼⵜ ⴰⵏⵏ ⵍⵍⵉ ⴷ ⵜⵜⴰⵡⵉⵖ ⵙⴳ ⵢⵉⵣⵔⵉ ⴷ ⵜⵎⵥⵉ	تلك الصور التي أستمدها من الماضي والطفولة
ⴷ ⵏⵡⴰⴷⵙ ⵙⵉⵙ ⴰⵏⴳⵉⵔⵉ ⴷ ⵓⵎⴰⴹⴰⵍ ⵏ ⴱⵕⵕⴰ	و نقصد به الإنفصال عن العالم الخارجي
ⵉⵎⴽⴰⵏⵏ ⴰ ⵉⵍⵍⴰⵏ ⴳ ⵜⴰⵣⵣⵓⵍⵉⵏ ⵢⴰⴹⵏⵉⵏ	نفس الأمر يسري على باقي المهن
ⵍⵍⵉⴳ ⵜⵜ ⵉⵏⵏ ⵏⴽⴽⴰ ⴰⵔ ⵏⵙⴽⴰⵔ ⵜⵓⵔⵎⵉⵢⵉⵏ ⵉⴷⵔⵓⵙⵏ	حين كنا نقدم تجارب قليلة
ⵓⴳⴳⴰⵔ ⵏ ⵙⵉⵎⵔⴰⵡ ⵏ ⵓⵙⴳⴳⵯⴰⵙ	لأزيد من عشرين عاماً
ⵉⵙ ⴷⴰ ⴷⵉⵙ ⵉⵜⵜⵎⵓⵏⴰ ⵓⵏⴳⴰⵥ?	هل يصاحبه ألم؟
ⴷ ⴰⵡⴷ ⵎⴰⴳⵏⵉⵣⵢⵓⵎ ⵉⴼⵓⵍⴽⵉ	وأيضا المغنيزيوم هو أيضا جيد
ⴷ ⵖⵉⵍⴰ ⵔⴰⴷ ⴼⵜⵓⵖ ⴰⴷ ⵙⵏⴱⴳⵉⵖ ⵢⴰⵏ ⵓⵏⴰⵥⵓⵕ ⴰⵄⵔⵔⵉⵎ ⴷⵉⵜⵏⵖ ⵉⵍⵍⴰⵏ ⴳ ⵓⴱⵍⴰⵟⵟⵓ	والآن سأنتقل للترحيب بفنان شاب حاضر معنا في البلاطو
ⴰⵢⴰⵏⵏ ⴰ ⵖⴼ ⴷⵉⵜⵏⵖ ⵜⵍⵍⴰ ⵍⴰⵢⵍⴰ ⴰⵢⵜ ⵎⵓⵍⵓⴷ	لذلك تحضر معنا ليلى آيت مولود
ⴷⴰ ⴷ ⵉⵜⵜⴰⵛⴽ ⵓⴼⴳⴰⵏ ⵍⵍⵉ ⴷⴰⵔ ⵜⵍⵍⴰ ⵙ ⵜⵣⵣⵔⴰⵢⵜ	يأتي الشخص المصاب للعيادة
ⵏⵖ ⴷ ⵜⵥⵍⵉ ⵙ ⵜⵙⵍⵉⵜ?	أم هي خاصة بالعروس؟
ⴰⵖⴰⵡⴰⵙ ⵉⵥⵍⵉⵏ ⵙ ⵜⵡⵊⴰ ⴷ ⵡⴰⵎⵓⵏ	البرنامج الخاص بالأسرة والمجتمع
ⵏⵙⵙⴽⵜⵉ ⵜ ⴷⴰⵖ	نعيد تذكيره
ⴰⴷ ⴷ ⵙⴳⵉⵙⵏⵜ ⵓⵔ ⵜⵜⴼⴼⵖⵏ ⵉⴹⴰⴳⴳⵯⵏ ⵉⴷⵓⵙⵏ	ألا تنبعث منها روائح قوية
ⵉⵍⵍⴰ ⵖⴼ ⵓⴼⴳⴰⵏ ⴰⴷ ⵉⵙⵏⵓⵙⵔⵓ ⵉⴽⵔⵔⴰⵛⵏ	على الشخص إنقاص التجاعيد
ⴰⵛⴽⵓ ⴷⴰⵔⵙ ⵜⴰⵣⵎⵔⵜ ⴷ ⵜⵖⴰⵔⴰⵙⵜ ⵏ ⵓⵙⵡⵉⵏⴳⵎ ⵏⵏⴰ ⵜ ⵢⵓⵊⵊⴰⵏ ⴰⴷ ⵜ ⵉⵏⵏ ⵉⵙⵙⴰⴳⴳⵓⴳ	لأن له قدرة وطريقته في التفكير جعلته يبعدها
ⵢⴰⵀ ⵍⵍⴰⵏ ⴽⵉⴳⴰⵏ ⵏ ⵉⵍⵓⵖⵎⴰ	نعم هناك العديد من التمارين
ⴷⴰ ⵉⵜⵜⵉⵍⵉ ⵓⵎⵓⴽⵔⵉⵙ ⴽⵓⴷⵏⵏⴰ ⵜⵣⵣⵔⴰⵢⴷ ⵉⵔⵉⵎ	يكمن المشكل عندما تجتاز الإمتحان
ⵉⵙ ⵓⵔ ⵉⴳⵉ ⵓⵢⴰⴷ ⴰⵙⴱⵖⵙ ⵏ ⵡⴰⵣⵣⴰⵏ?	ألا يمكن إعتبار هذا تحفيزا للطفل؟
ⴰⵙⴰⴳⵎ ⴰⵏⵎⵖⴰⵢ ⵓⵔ ⵔⴰⴷ ⴰⵙ ⵉⴼⴽ ⴰⵢⵍⵍⵉ ⵉⵍⵍⴰⵏ ⴳ ⵜⴳⵣⵣⵓⵎⵜ ⵏ ⵜⴼⵉⵢⵉ	المصدر النباتي لن يمنحه ما في قطعة لحم
ⵜⴰⴼⴽⴽⴰ ⵏ ⵓⴼⴳⴰⵏ ⵜⴳⴰ ⵣⵓⵏ ⴷ ⵜⵉⵀⵉⵔⵉⵜ	جسم الإنسان نعتبره كسيارة
ⵜⴰⵛⴽ ⴷ ⵜⵙⵡⵉⵏⴳⵎⵜ ⵙⴳ ⵜⵙⵓⵎⵔⵜ ⵏⵏⵙⵏⵜ ⵙ ⵓⵙⵔⴰⴳ ⵏ ⵜⵕⵡⵉ ⵏ ⵓⵣⴰⵜⵉⵎ ⴰⴷ	وأتت الفكرة من إقتراحهن نظرا لفعالية هذا الزيت
ⴷⴰ ⵏⵛⵜⵜⴰ ⵛⵛⴽⵯⵍⴰⵟ	نتناول الشكولاتة
ⵜⵉⵔⵉⴷ ⴰⴷ ⵜⵙⴽⵔⴷ ⴰⵢⴰⵏⵏ ⵜⵙⵢⴰⴼⴰⴷ ⵙ ⵜⵎⵙⵜⴳⴳⴰⵔⵜ ⴳ ⵓⵙⴳⴰ ⵏ ⵡⴰⵎⵓⵏ	و تحب القيام بذلك وتحس بالمسؤولية تجاه المجتمع
ⴷ ⵎⴰⵢⴷ ⵢⴰⴷⵍⵍⵉ ⴳⴰⵏ ⵉⴼⵔⴷⵉⵙⵏ ⵏ ⵓⵖⵓⵊⵊⵔ	وما هي مكونات الإفطار أساسا
ⵍⵍⴰⵏ ⵡⵉⵍⵍⵉ ⵓⵔ ⵉⵙⵙⵉⵏ ⴰⴷ ⵡⵓⵛⵓⴼ	هناك من لا يتقن السباحة
ⴷⴰ ⵉⵜⵜⴰⵙⵉ ⵜⵉⵍⵉⴼⵓⵏ	يحمل الهاتف
ⵔⴰⴷ ⴳⴱⵓⵖ ⵡⵉⵢⵢⴰⴹ	سأثقب أخريات
ⴰⵛⴽⵓ ⴷⴰⵔⵙⵏⵜ ⵜⵓⵔⵎⵉⵜ ⴷ ⵥⴹⴰⵕⵏⵜ ⴰⴷ ⵙⵎⴽⵍⵏⵜ ⵎⵏⵏⴰⵡⵜ ⵜⵙⴳⵉⵡⵉⵏ	لأنها تملك خبرة و بإمكانها أن تهتم بعدة جوانب
ⵉⵥⴹⴰⵕ ⴰⴷ ⵉⴽⴽⵙ ⵣⵣⵏⴽ ⴷ ⵓⴽⴰⵍⵙⵢⵓⵎ	قد يزيل الزنك والكالسيوم
ⵉⵎⴰⵏⵏⴰⵢⵏ ⵏⵏⵖ ⵜⵉⵎⴰⵏⵏⴰⵢⵉⵏ ⵏⵏⵖ ⵉⵥⵉⵍⵏ ⴰⴷ ⴰⵡⵏ ⵉⵏⵉⵖ	مشاهدينا مشاهداتنا الأعزاء أقول لكم
ⵜⵉⵣⵉ ⵏ 10 ⵜⵓⵙⴷⵉⴷⵉⵏ	لمدة 10 دقائق
ⴷⴷⵉⵖ ⴷⴰⵔⵙ ⵜⵎⵓⵏ ⴷⵉⵜⵉ ⴷⴰⵔ ⴷⴷⵎⵙⵉⵔⵉ ⵜⵉⴽⴽⵍⵜ ⵜⴰⵎⵣⵡⴰⵔⵓⵜ	ذهبت إليها و رافقتني عند الدمسيري لأول مرة
ⵉⵍⵍⴰ ⵓⵎⵙⴽⴰⵔ ⴰⴳⵏⵙⴰⵏ ⴱ12	هناك العامل الداخلي ب12
ⵜⵖⵥⴰⵏⴷ ⴰ ⵓⵍⵜⵎⴰ ⵜⵓⴷⴰ	صحيح أختي تودا
ⵉⵙ ⴷ ⴽⵓ ⴰⵏⴰⵡ ⴷⴰⵔⵙ ⴰⴷⵖⴰⵔ ⵙⵉⵙ ⵉⵥⵍⵉⵏ ⵏⵖ ⴷ ⵓⵀⵓ?	هل لكل نوع مكان مخصص له أم لا؟
ⴷ ⵉⴷⵓⴽⴰⵏ ⴷ ⵜⵣⵓⵣⴰⴼ	والحذاء والمجوهرات
ⴰⴼⴰⴷ ⴰⴷ ⵏⴽⵛⵎ ⵙ ⵜⵢⵢⵓⵖⵉⵏ, ⵉⵍⵎⵎⴰ ⵓⵔ ⴷⴰ ⵏⴽⵛⵛⵎ ⵙ ⵢⵉⵍⵍ ⵏⵏⵉⵛⴰⵏ	ثم نلج الأمواج، أي أننا لا ندخل البحر مباشرة
ⴷ ⵎⵏⵏⴰⵡ ⵡⴰⵏⴰⵡⵏ ⵏ ⵉⴼⵛⴽⴰ	وأنواع كثيرة من الأواني
ⵎⴰⵛⵛ ⵖⵉⵍⴰ ⵓⵔⵔⵉⵏ ⵙ ⵓⵇⴱⵓⵔ	لكن الآن عادوا للقديم
ⵣⵓⵏ ⴷ ⵜⵉⵕⵥⵉ ⵉⵙⴽⵔ ⴽⵔⴰ ⵏ ⵓⵏⴳⴰⵙ	مثل الكسر عند التعرّض لحادث
ⴷ ⴰⴷ ⵓⵔ ⵏⵇⵇⵍ ⴰⵔⴷ ⵉⵙⵇⵙⴰ	ولا ننتظر حتى يسأل
ⴷ ⵍⵍⵉⴳ ⵜⴳⵉⴷ ⵢⴰⵏ ⵓⴼⴳⴰⵏ ⵙⴳ ⵎⴷⴷⵏ	فما دمت فردا من البشرية
ⵏⵙⴰⵡⵍ ⵖⵉⵍⴰ ⵖⴼ ⴳⴰⵔ ⵜⵉⵖⴰⵡⵙⵉⵡⵉⵏ	تكلمنا الآن عن الأمور السيئة
ⴰⴼⴰⴷ ⴰⴷ ⵉⵙⵙⵓⵏⵖ ⴰⵣⵎⵓⵎⵎⴳ ⵖⴼ ⵡⵓⴷⵎⴰⵡⵏ ⵏ ⵡⴰⵣⵣⴰⵏⵏ	ليرسم البسمة على وجوه الأطفال
ⴰⴼⴰⴷ ⴰⴷ ⵣⵔⵉⵏ ⵜⵖⴰⵡⵙⵉⵡⵉⵏ ⵙ ⵜⵖⴰⵔⴰⵙⵜ ⵉⴼⵓⵍⴽⵉⵏ	لتمر الأجواء بأفضل الأحوال
ⵉⵎⴰ ⵣⵓⵏ ⴷ ⵜⵓⵜⵜⵔⴰ ⵉⵥⵍⵉⵏ	إما كطلبية خاصة
ⴽⵓⴷⵏⵏⴰ ⵜⵍⵍⵉⴷ ⵎⵏⵉⴷ ⵏ ⵢⵉⴼⴹ ⵏ ⵎⴷⴷⵏ	عندماتكون أمام ألف من الناس
ⵙⵙⵏⵜⵉⵖ ⴳ ⵢⵉⴳⵔ ⵏ ⵓⵙⵓⵏⵖ ⵙⴳ ⵜⵎⵥⵉ	بدأت في مجال الرسم منذ الصغر
ⵎⴰⵛⵛ ⵏⴽⴽⵉⵏ ⵍⵍⵉⴳ ⵎⵥⵥⵉⵢⵖ ⴽⴽⵉⵖ ⵜⵜ ⵉⵏⵏ ⴰⵔ ⵜⵜⵉⵔⵉⵖ ⴰⵃⵡⴰⵛ	لكنني عندما كنت صغيرة كنت أحب فن أحواش
ⵍⵍⴰⵏ ⵎⵏⵏⴰⵡ ⵡⴰⵏⴰⵡⵏ	هناك عدة أنواع
ⵖⴼ ⵜⴰⵙⵙⴰⵙⵜ ⵏⵏⴰ ⴰⵖ ⵉⵜⵜⴰⵎⵥⵏ ⴷ ⵏⴽⴽⵏⵉ ⴷⴰ ⵏⵙⴰⵡⴰⵍ ⵎⵏⵉⴷ ⵏ ⵓⴳⴷⵓⴷ	عن التوتر الذي يتملكنا ونحن نتحدث أمام الجمهور
ⴳ ⵜⴰⵎⵜ ⵜⵙⵔⴰⴳⵉⵏ ⴰⵏⵏ	في تلك ثمانية ساعات
ⵏⵖ ⵉⵥⴹⴰⵕ ⴰⴷ ⵉⴳ ⴰⵎⵥⵢⴰⵏ ⴷ ⵡⴰⵍⵍⵉ ⵜⵜⵉⵔⵉⵏ ⴷⴰⵔ ⵉⵎⴰⵔⴰⵡⵏ	أو ربما يكون الأصغر والمحبوب لدى الوالدين
ⵥⴹⴰⵕⵏ ⴰⴷ ⴳⵉⵙ ⴹⵕⵏ ⵡⴰⵔⵔⴰⵡⵏ ⵏⵏⴽ ⴳ ⵢⵉⵎⴰⵍ	هناك إحتمال أن يقع فيها أبناؤك مستقبلا
ⴷⴰ ⵜ ⵏⴼⵙⵙⵔ ⵙ ⵜⵖⵣⵉ	نقوم ببسطها بالطول
ⴰⵙⵏⴼⵍ ⵉⴳⴰ ⵜⴰⵎⵍⴷⴰ ⵏ ⵜⵓⴷⵔⵜ ⴳ ⵓⵙⵡⵉⵔ ⵢⵓⴼⵏ	التغيير هو فرصة للعيش في مستوى أحسن
ⴰⵛⴽⵓ ⴰⴽⵯⴼⴰⵢ ⵏ ⵡⴰⵣⵣⴰⵏ ⵉⵇⵇⴰⵏ ⴷ ⴰⴷ ⵢⴰⵎⵓ ⴰⵡⴷ ⵉⵏⴷⴷⴰⴷⵏ	لأن حليب الطفل يجب أن يشمل الدهنيات أيضا
ⴷ ⵓⵣⴳⵣⴰⵡ ⴰⴽⴰⵡⴽⴰⵡ	والأخضر الفستقي
ⵜⴰⴷ ⵉ ⵜⵎⵖⴰⵔⵉⵏ ⴷ ⵉⵔⴳⴰⵣⵏ	هذه للنساء والرجال
ⵜⴰⵏⵎⵎⵉⵔⵜ ⵏⵏⴽ ⴰ ⵄⵓⵎⴰⵔ ⵔⴰⴷ ⵏⵙⵎⴷ ⴰⵡⴰⵍ ⵏⵏⵖ	شكرا لك عمر سأستأنف حديثنا
ⵉⵍⵉⵏⵜ ⴷⴰⵔⵙ ⵜⵓⴳⵜⵜ ⵏ ⵜⵡⵓⵔⵉⵡⵉⵏ, ⵎⴰⵛⴰ ⵓⵔ ⵉⵥⴹⵉⵕ ⴰⴷ ⵜⵏⵜ ⵉⵙⴽⵔ	فيكون متابعا بأشغال لكنه عاجز عن القيام بها
ⴷ ⵓⵢⵍⵍⵉ ⴰⴽⴽⵯ ⵉⵜⵜⵊⵕⵓⵏ ⴳ ⵜⵓⴷⵔⵜ ⵏⵏⵙ	وكلما يحدث في حياته
ⵎⴰⵢⴷ ⵜⵜⵉⵔⵉⵏ ⴷ ⵎⴰ ⴳ ⵔⴰⴷ ⵙⵏⴼⵍⵓⵍⵏ ..	ما يحبونه وما سيبدعون ويتفننون فيه
ⵎⴰ ⵖⴼ ⴷⴰ ⵏⵙⵇⵙⴰ ⵉⵙⵇⵙⵉⵜⵏ ⴰⴷ ?	لماذا نطرح هذه الأسئلة ؟
ⴰⴷ ⵉⵥⴹⴰⵕ ⴰⴷ ⵢⴰⵍⵙ ⴰⵙⵡⵉⵏⴳⵎ ⴳ ⵎⴰ ⴳ ⴷⴰ ⵉⵙⵡⵉⵏⴳⵉⵎ	بأن يستطيع أن يعيد التفكير فيما يفكر فيه
ⴰⵢⴰⴷ ⴰ ⵖⴼ ⵙⴳⵉⵜⵏⵖ ⵜⵓⴳⵜⵜ ⵏ ⵡⴰⴽⵓⴷ	لهذا يتطلب منا للكثير من الوقت
ⵎⴰⵅⵅ ⵉⵎⵔⴰ ⵖⴼ ⵓⴼⴳⴰⵏ ⴰⵙⵏⴼⵍ ⵏ ⵜⵡⵓⵔⵉ ⵉⵍⵎⵎⴰ ⵓⴼⵓⵖ ⵙⴳ ⵜⵎⵏⴰⴹⵜ ⵏ ⵓⵙⵡⵓⵏⴼⵓ?	لماذا يستعصي على الانسان تغيير العمل وبالتالي التحرر من منطقة الراحة؟
ⵍⵍⵉⴳ ⵓⵔ ⵏⴷⴳⴳⵉ ⴰⵎⵣⴰⵔⴰⵢ ⵜⵉⵣⵉ ⴰⵏⵏ	عندما لم نتقبل ساعتها الإختلاف
ⵎⴰⵛⵛ ⵉⴳ ⴷⵉⵎ ⵓⵔ ⴳⵉⵡⵔⵖ ⴷ ⴰⵔ ⴽⴰ ⵥⵕⵕⴰⵖ ⵜⵉⵡⵍⴰⴼⵉⵏ	لكن إذا لم أجلس معك وأشاهد الصور فقط
ⵉⵍⵎⵎⴰ ⴷⴰ ⵜ ⵜⴻⵜⵜⴰⴼⴰⴷ ⵉⴳⴰ ⵓⴽⵕⵉⴹ ⴷ ⴷⴰ ⵉⴽⴽⴰⵜ ⵉⵎⴷⴷⵓⴽⴽⴰⵍ ⵏⵏⵙ ⴷ ⵡⴰⵔⵔⴰⵡⵏ ⵏ ⵉⵏⴰⵔⴰⴳⵏ	لدى تجده عنيفا و يضرب زملاءه و أبناء الجيران
ⴷⴰⵔⵏⵖ ⵙ ⵓⵎⴷⵢⴰ ⵙⵉⵏ ⵉⵎⵢⵉⵡⵍⵏ	لدينا مثلا زوجان
ⵍⵍⴰⵏⵜ ⴽⵔⴰ ⵏ ⵜⵎⵖⴰⵔⵉⵏ ⴷⴰ ⵙⴽⴰⵔⵏⵜ ⴽⵔⴰ ⵏ ⵜⵡⵓⵔⵉ ⵜⴰⵡⴼⵓⵙⵜ ⵉ ⵉⵔⴳⴰⵣⵏ ⵏⵏⵙⵏⵜ	هناك بعض الزوجات ينجزن أعملا يدوية من أجل أزوجهن
ⵜⵉⴼⵉⵢⵉ ⵉⵜⵜⵓⵥⴹⴰⵏ	اللحم المفروم
ⵉⵎⴽⵍⵍⵉ ⵜⵓⵎⴰ ⵜⵎⵍⵙⵉⵜ "ⵙⵙⴼⵉⴼⴰ"	كما يحتوي اللباس على ’’السفيفة‘‘
ⴰⵢⵍⵍⵉ ⵉⵀⵎⵎⴰⵏ ⵉⴳⴰ ⵜ ⵎⴰⵙ ⴷ ⵉⵇⵇⴰⵏ ⵖⴼ ⵜⵎⵖⴰⵔⵜ ⴰⴷ ⵜⵙⵙⵏⴼⵍ ⵉⴼⵖ ⵏⵏⵙ	المهم هو أن المرأة يجب عليها أن تغير من نفسها
ⵏⵔⴰ ⴰⴷ ⴰⵖ ⵜⵙⴰⵡⵍⴷ ⵖⴼ ⵉⵎⴰⵙⵙⵏ ⴰⴷ	نريد أن تحدثنا عن هذه الأدوات
ⵜⴰⵎⵙⵙⵏⴰ ⴷ ⵜⵓⵙⵙⵏⴰ ⴷⴰ ⵜⵜⴰⴷⴷⵓⵏ	المعرفة والعلم تتجه
ⴰⴼⴰⴷ ⴰⴷ ⵏⵥⵕ ⵎⴰⵢⴷ ⴰⵖ ⵙⵎⵓⵜⵜⴳⵏ ⴳ ⵜⴳⵟⵟⵓⵎⵉⵏ ⵏⵏⵙⵏ	لنرى ماذا أعدوا لنا في فقراتهم
ⵣⵓⵏ ⴷ ⴰⴱⵓⵔⴽⵙ ⵉⴽⵕⵕⵓⵥⵏ ⵜⵥⴹⴰⵕ ⴰⴷ ⴷ ⵜⵓⵔⵔⵉ ⵜⴼⴰⴼⵜ	كالحذاء الضيق يمكن أن يعود الورم
ⵉⵎⴽⵍⵍⵉ ⵜⵙⵜⴰⵢⴷ ⴰⵎⵜⵛⵓ ⴰⴷⵓⵙⴰⵏ	كما تختار الطعام الصحي
ⵙⴰⵏⵉⴷⴰ	سكر حبيبات
ⵉⴷⴷⴻⴷ ⴷ ⵓⵔ ⵉⵥⴹⵉⵕ ⴰⴷ ⵢⵉⵏⵉ ⵢⴰⵜ ⵜⵡⵉⵏⵙⵜ	و يتعرق و غير قادر على نطق جملة واحدة
ⵙ ⵉⵣⵡⵉⵔ ⵏⵔⴰ ⴰⴷ ⵏⵙⵙⵏ ⵎⴰⵢⴷ ⵉⴳⴰ ⵓⴼⵓⴽⴽⵙ ⴰⴷ	أولا نود أن نعرف ماهي هذه المهارة
ⴷ ⵉⴳ ⵉⵡⵉⵙ ⵏ ⵄⵎⵎⵉⵙ ⵏ ⵃⵎⴰⴷ ⵙⵙⵍⵟⴰⵏ	وإبن عم أحمد سلطان
ⴷⴰ ⴰⵙ ⴰⴽⴽⴰⵖ ⵢⴰⵜ ⵜⴼⵍⵡⵉⵜ	فإنني أقدم له جدولًا
ⴷⴰ ⴷ ⵜⵏⴽⴽⵔⴷ ⴳ ⵜⵉⵙⵙ ⵙⴰ ⵏ ⵜⵓⴼⴰⵜ	تستيقظين في السابعة صباحا
ⵉⵎⵥⵢⴰⵏⵏ ⴷⴰ ⵙⴽⴰⵔⵏ ⵣⵓⵏ ⴷ ⵏⵜⵜⵏⵉ ⵙ ⵢⴰⵏ ⵡⴰⵏⴰⵡ ⵏ ⵓⵙⵎⵣⴰⵣⴰⵍ	الصغار يبدأون بالتقليد كنوع من المقارنة
ⴷ ⵓⵢⴰⴷ ⵉⵙⵙⵓⵜⵔ ⴰⴷ ⵜⵉⵍⵉ ⵜⵔⴰⴱⴱⵓⵜ ⵜⴰⵎⴰⵣⵣⴰⴳⵜ ⵉ ⵓⵙⵡⵓⵔⵉ ⵖⴼ ⵜⵎⴰⵛⵉⵏⵜ	وهذا يستوجب توفر طاقم متخصص للعمل على الالة
ⴰⵛⴽⵓ ⴰⴱⵓⵅⵎⵓ ⴷⴰ ⵉⵜⵜⴰⵖ ⵜⴰⴼⴽⴽⴰ ⴰⴽⴽⵯ	لأن التعفن يصيب كامل الجسم
ⵏⵖ ⵉⴳⴰ ⴱⴰⴱ ⵏⵏⵙ	أو تكون في ملكيته
ⵉⵎⴰⵏⵏⴰⵢⵏ ⵏⵏⵖ ⵉⵥⵉⵍⵏ	مشاهدينا الكرام
ⴷ ⵡⴰⴷⴷⴰⴷ ⵏ ⴱⴰⴱⴰⴽ ⴷ ⵉⵎⵎⵉⴽ ⴷ ⵜⵡⵊⴰ	ووضعية الأب والأم والأسرة
ⴷ ⴳ ⵢⴰⵏ ⵡⴰⵙⵙ ⴳ ⵡⵓⵙⵙⴰⵏ ⵓⵔ ⴷ ⵢⵓⵡⵉ ⵢⴰⵜ	وفي أحد الأيام لم يحصل على شيء
ⵏⵖ ⵜⴰⵎⵓⴽⵔⵉⵙⵜ ⴳ ⵢⴰⵏ ⵢⵉⴳⵔ	أو إشكالية في مجال
ⴷ ⴰⴷ ⵜⵏ ⵙⵙⵓⴼⵖⵏ ⴰⴼⴰⴷ ⴰⴷ ⵥⵕⵏ ⵎⴷⴷⵏ ⴷ ⵓⵎⴰⴹⴰⵍ ⵏ ⴰⴱⵕⵕⴰⵏⵉ	ويخرجوهم لإكتشاف الناس والعالم الخارجي
ⵜⴰⴷ ⵙⴳ ⵡⴰⵣⴰⵍⵏ ⴷ ⵓⵙⴽⵕⵕⵓⵥ ⵖⴼ ⵢⵉⵖⴼ	هذه عن القيم والتضييق على الذات
ⴷⵓⴽⵜⵓⵔ, ⵏⴽⴽⴰ ⵜⵜ ⵉⵏⵏ ⴰⵔ ⵏⵙⴰⵡⴰⵍ ⵖⴼ ⵜⵎⴰⵎⴽⵜ ⵏ ⵡⴰⴽⴰⵣ ⵏ ⵡⴰⵟⵟⴰⵏ ⵏ ⵓⴽⵓⵍⵓⵏ ⴰⵏⵣⵍⵓⵎ	دكتور، كنا بصدد الحديث عن كيفية تشخيص مرض القولون العصبي
ⴷ ⵜⵙⵎⵎⴰⵎⵜ	والليمون
ⵉⵖⵓⵊⵊⵔ ⵙ ⵉⵙⴽⴽⵯⴰⵔⵏ ⴷ ⵓⵢⵍⵍⵉ ⴰⵙ ⵓⵔ ⵉⴳⵉⵏ ⵓⴱⵖⵉⵔ	ويفطر على السكريات وما لن يعود عليه بالنفع
ⵉⴳⴰ ⵜⵉⴽⵕⴹⵉ ⵜⴰⵏⵉⵎⴰⵏⵜ	يعد عنفا نفسيا
ⵔⴰⴷ ⵏⴰⵊⵊ ⵓⵔⴽⵉⵙ ⵜⵉⵣⵉ ⵏ 5 ⵜⵓⵙⴷⵉⴷⵉⵏ	سنترك الخليط لمدة من 5 دقائق
ⴳ ⵜⵎⵉⵣⴰⵔ ⵏⵏⵖ ⴰⵎⴰⵜⴰ ⵏ ⵎⴷⴷⵏ ⴷⴰ ⵛⵜⵜⴰⵏ ⵜⵉⵙⵔⴰⴽⵜⵉⵏ ⵙ ⵜⵓⴳⵜⵜ	في بلادنا معظم الناس يتناولون الحلويات بكثرة
ⵉⵍⵍⴰ ⴼⵍⵍⴰⵙⵏ ⴰⴷ ⴹⴼⵕⵏ ⵉⵙⵎⵎⵜⴰⵔ ⵏ ⵓⵎⵙⴳⵏⴰⴼ	عليهم إتباع نصائح الطبيب
ⵙ ⵉⵎⴽⴰ ⴷⴰ ⵏⵜⵜⴰⴼⴰ ⴰⵣⴰⵍ ⴰⴼⴽⴽⴰⵏ	هكذا نحصل على القيمة الجسمية
ⵏⵖ ⵜⴰⵡⴰⴷⴰ ⵙ ⴽⵔⴰ ⵏ ⵓⴷⵖⴰⵔ ⵙⵡⴰ ⵍⵇⵀⵡⴰ ⵏⵖ ⵜⴰⵖⴰⵔⵜ ⵏ ⵢⵉⵍⵍ	أو الذهاب لمكان ما سواء المقهى أو الشاطئ
ⴳ ⵉⴷ ⵙⴰⵎⵔⴰⵡ ⵏ ⵜⴰⵙⵓⵜ ⵉⵣⵔⵉⵏ	في سبعينيات القرن الماضي
ⵎⴰ ⵉⴳⴰⵏ ⵜⴰⴷⵖⵔⴰⵏⵜ?	ما المقصود بالمجالية؟
ⴰⴼⴰⴷ ⴰⴷ ⵏⵥⵕ ⵉⵙ ⴷⴰ ⵉⵙⵢⴰⴼⴰ ⵏⵖ ⴷ ⵓⵀⵓ	لنرى ما إذا كان يشعر أم لا
ⴷ ⵓⵎⵉⴳⴰ 3 ⵉⵍⵍⴰ ⴳ ⵓⵣⴰⵜⵉⵎ ⵏ ⵍⴽⵜⵜⴰⵏ	والأوميجا 3 متوفر في زيت الكتان
ⵎⴰⵛⵛ ⴷ ⵡⴰⴽⵓⴷ ⵓⴳⴳⵯⴰⵏⵜ ⴷ ⴳⵉⵙ ⵜⵎⵉⵜⴰⵔ ⵏ ⵜⵡⵍⴰⵡⴰⵍⵜ	لكن مع الوقت ظهرت عليه أعراض التوحد
ⵖⴼ ⵜⵉⵔⵎⵜ ⴰⴷ ⵍⵍⵉ ⴰⵖ ⵜⵙⵎⵓⵜⵜⴳⴷ	على هذه الوصفة التي حضرتها
ⴰⵎⵎ ⴰⵏⴳⵉⴷⴷⵉ ⵏ ⵉⵙⵓⵍⴼⵏ ⴳ ⵜⴼⵓⴳⵍⵉⵡⵉⵏ ⵏ ⵜⵥⵓⵕⵉ ⴷ ⵉⵏⵎⵓⴳⴳⴰⵔⵏ ⵉⵜⵜⵓⵙⵏⵎⴰⵍⴰⵏ ⴳ ⵜⵎⴰⵣⵉⵔⵜ	مثل تكافؤ الفرص في التظاهرات الفنية والمهرجانات المنظمة في البلد
ⵜⵉⴼⵔⵅⵉⵏ ⵉⵜⵜⴷⴷⵓⵏ ⵙ ⵜⵎⵚⵕⴰⵢ ⵏ ⵓⵙⵖⵓⴷⵓ	الفتيات اللواتي يذهب إلى صالونات التجميل
ⵎⴰ ⵉⴳⴰⵏ ⴰⴼⵙⵙⴰⵢ?	ما الحل؟
ⵉⵥⴹⴰⵕ ⴰⴷ ⵉⴳ ⵜⴰⴱⴱⴰⵢⴹⴰⵕⵜ ⵉⵍⵎⵎⴰ ⵓⵔⵔⵉⵖ	من الممكن أن يكون عائقا فأتراجع
ⵡⴰⴷ ⵉⵜⵜⵓⵙⴽⴰⵔ ⵙⴳ ⵓⵙⴰⵜⵉ ⵏ ⵜⵙⴼⵕⴹⵜ	هذا مصنوع من إطار الجرافة
ⵎⴰⵛⵛ ⴽⵔⴰ ⵓⵔ ⴷⴰ ⵙⵉⵙ ⵉⵜⵜⵍⵓⵍ	أما البعض فلا يولد بها
ⵎⴰⵛⵛ ⴽⵓ ⴰⴼⴳⴰⵏ ⴷ ⵉⵙⵉⵣⵡⵉⵔⵏ ⵏⵏⵙ ⴳ ⵉⵣⴰⵍⵏ	إلا أن كل شخص وأولوياته في القيم
ⴰⵔ ⴽⵎ ⵏⵙⵏⵉⵎⵎⵉⵔ ⴷ ⴰⵢⵢⵓⵣ ⵏⵏⵎ	نشكرك و نحيك
ⴰⵢⴰⴷ ⴰ ⵖⴼ ⴷ ⵉⵇⵇⴰⵏ ⴷ ⴰⴷ ⴷⴰⵔⴽ ⵜⵉⵍⵉ ⵜⵎⵓⵏⵜ ⵉⴼⵓⵍⴽⵉⵏ	لذا يجب أن تكون لديك رفقة حسنة
ⴰⵢⴰⴷ ⴰⵢⴷ ⵏⵡⴰⴷⵙ ⵙ ⵡⵓⵔⵔⵉⴼ	هذا ما نقصده بالغضب
ⴰⵢⴰⴷ ⴰ ⵖⴼ ⴳ ⵕⵎⴹⴰⵏ ⴷⴰ ⵜⴻⵜⵜⵏⵔⵏⴰⵢ ⵜⴰⵥⴰⵢⵜ ⵏ ⴽⵉⴳⴰⵏ ⵏ ⵎⴷⴷⵏ	لذلك في رمضان يزداد وزن العديد من الأشخاص
ⵓⵔ ⵊⵊⵓ ⵔⴰⴷ ⵏⵏ ⵏⴰⴼ ⵡⴰⵍⵍⵉ ⵉⵛⵜⵜⴰⵏ ⵓⵜⵛⵉ ⴰⴼⵔⵢⴰⵏ	لن نجد أبدا من يتناول التغذية العاطفية
ⵙ ⵓⵎⴷⵢⴰ ⵉⴳ ⵏⴻⵏⵏⴰ ⵉ ⴽⵔⴰ ⵏ ⵢⴰⵏ ⴳ ⵜⵎⴰⵣⵉⵔⵜ ⵜⴰⵡⵕⵓⴱⴱⵉⵜ	مثلا إذا طلبنا من شخص بدولة أوروبا
ⵙⵙⵓⵎⵔⵖ ⴰⵙ ⵜⴰⵙⵡⵉⵏⴳⵎⵜ ⵉⵍⵎⵎⴰ ⵜⵙⵙⵓⵙⵎ ⵜ ⴱⴰⵀⵔⴰ	إقترحت عليه الفكرة فأعجبته كثيرا
ⵡⴰⴷ ⵉⴳⴰ ⵜⵓⵍⵖⴰ ⵏⵖ ⴰⵙⴱⵖⵙ ⵓⵙⵔⵉⴷ	هذا يكون مدحا أو تحفيزا مباشرا
ⵎⴰ ⵉⴳⴰⵏ ⵜⵉⴽⵕⴹⵉ ⵜⴰⵡⵊⴰⵡⴰⵏⵜ?	ما هو العنف الأسري؟
ⴰⵛⴽⵓ ⴰⴼⴳⴰⵏ ⴷⴰ ⵉⵜⵜⴰⵥⵓⵎ ⵖⴼ ⵎⵏⵏⴰⵡ ⵉⵙⵔⴰⴳⵏ	لأن الإنسان يصوم لأسباب متعددة
ⵏⴱⴱⵉ ⵜ ⵖⴼ ⵜⴳⵣⵎⵉⵏ ⵜⵉⵎⵥⵢⴰⵏⵉⵏ ⴰⴼⴰⴷ ⴰⴷ ⵉⵔⵅⵓ ⵉⵙⵏⵡⵉ ⵏⵏⵙ	نقطعها إلى قطع صغيرة ليسهل طهيها
ⴷⴰ ⵜⵜⵢⴰⵔⴰⵎⵏⵜ ⵖⴼ ⵜⵓⵖⵎⴰⵙ	تجرب على الأسنان
ⵜⴰⴼⴷ ⵏⵏ ⵎⴰⵙ ⴷ ⴰⵙⵍⵉ ⴷ ⵜⵙⵍⵉⵜ ⴷⴰ ⵜⵜⴰⴳⵯⵉⵎ ⴰⵢⴰⵏⵏ	و تجد بأن العروس و العريس يرفضون ذلك
ⵖⵉⴷ ⴰ ⴳ ⵉⵍⵍⴰ ⵓⵎⵓⴽⵔⵉⵙ, ⵙ ⵓⵏⵛⵜ ⵏⵏⴰ ⴳⴳⵓⵜⵏⵜ ⵜⵃⵓⵏⴰ ⴰⴷ	هنا يكمن الإشكال فكلما كثرت هذه المحالات
ⴷⴰ ⵜⵜ ⵏⵙⵙⵎⵔⴰⵙ ⴽⵓⴷⵏⵏⴰ ⵏⵙⴽⴰⵔ ⴽⵔⴰ ⵏ ⵜⵡⵓⵔⵉ	نستحضره أثناء أداء مهمة معينة
ⴰⵛⴽⵓ ⵓⵔ ⵉⵍⵍⵉ ⴽⵔⴰ ⵏ ⵓⴼⴳⴰⵏ ⴳ ⵉⴳⴳⵉ ⵏ ⵡⴰⴽⴰⵍ ⵓⵔ ⵉⵥⴹⵉⵕⵏ ⵉ ⵓⵢⴰⵏⵏ	لأنه ليس هناك شخص على وجه الأرض لا يستطيع ذلك
ⵔⴰⴷ ⵜ ⵏⵙⵙⵔⵖ	سنوقده
ⵜⴰⴳⵍⴰⵢⵜ ⴷ ⵓⴽⵕⴽⴰⵥ ⴷ ⵍⵅⵍⵍ	بيضة والخردل والخل
ⵎⴰⵛⴰ ⵉⴳ ⴰⵙ ⵜⵏ ⴰⴽⴽⵯ ⵜⵎⵍⵉⴷ, ⵉⵥⴹⴰⵕ ⴰⴷ ⴰⴽ ⵙⵓⵍ ⵓⵔ ⵉⵖⵔ	أما إذا أطلعته على كل شيء قد لا ينادي عليك
ⵉⵎⴽⵍⵍⵉ ⴰⵎ ⵢⴰⴷ ⵏⵏⵉⵖ, ⴷⴰ ⵙⵙⵎⵔⴰⵙⵖ ⴰⵙⵖⴰⵔ ⵉⵜⵜⵢⴰⴷⴰⵔⵏ	كما ذكرت لك من قبل أستخدم الخشب المضغوط
ⴰⵎⵣⴰⵔⴰⵢ ⴳⵔ ⵓⵙⴰⵎⵎⵖ ⴷ ⵓⵏⵎⴳⴰⵍ ⵏ ⵜⵕⵥⵉ	الفرق بين الزجاج والمضاد للكسر
ⵉⵎⴽⵍⵍⵉ ⵙⵉⵖ ⵉⵜⵜⵎⴰⵜⵜⴰⵢ ⵓⵙⵉⵖⵉ	كما تنتقل لنا العدوى
ⴰⵏⴰⵥⵓⵕ ⵀⵉⵛⴰⵎ ⵎⴰⵙⵉⵏ	الفنان هشام ماسين
ⴳ ⵓⵏⵛⵜ ⵏ ⵓⵢⵍⵍⵉ ⵜⵔⴰ ⵜⵎⵖⴰⵔⵜ	حسب رغبة المرأة
ⴰⵔ ⵥⵕⵕⴰⵖ ⵎⴰⵙ ⴷ ⴰⵎⵣⴳⵓⵏ ⵉⵍⴽⵎ ⵉⴷⵖⴰⵔⵏ ⵓⵔ ⵜⵏ ⵢⴰⴷⵍⵍⵉ ⵉⵍⴽⵉⵎ	أرى أن المسرح قد وصل إلى أماكن لم يصلها من قبل
ⴰⵛⴽⵓ ⴽⵔⴰ ⵏ ⵜⵎⵙⴽⴰⵔ ⵓⵔ ⴷⴰ ⴷ ⵜⵜⴰⴳⴳⵯⴰⵏⵜ ⴳ ⵜⵎⵥⵉ	لأن بعض السلوكيات لا تظهر في الطفولة
ⵏⴹⴼⵕ ⵜⴰⵖⴰⵔⴰⵙⵜ ⵢⴰⴽⵙⵓⵍⵏ ⵉ ⵍⵅⵓⵅ	نتبع نفس الطريقة بالنسبة للخوخ
ⵉⵎⴰ ⵜⵉⴼⵙⵜ ⵜⴳⴰ ⵍⴽⵔⵉⴱ	أما الثوب فهو الكريب
ⴰⵡⴷ ⴰⴷ ⵓⵔ ⵢⴰⵡⵍ ⵖⴼ ⵜⵏⴼⴰⵍⵜ	كذلك لا يتزوج زواج مصلحة
ⴰⵢⵍⵍⵉ ⵓⵔ ⵉⵜⵜⴰⵊⵊⵏ ⴰⵍⴽⴰⵎ ⵏ ⵉⵙⴰⵖⴷⵏ	وهو ما يعرقل بلوغ الأهداف
ⵉⵍⵎⵎⴰ ⴰⵙⴽⴽⵯⴰⵔ ⵏ ⵙⴰⵏⵉⴷⴰ, ⵜⴰⵏⵖⴷⴰ ⵏ ⵍⴽⵔⵉⵎ ⵏ ⵜⵙⵔⴰⴽⵜⵉⵏ ⴷ ⵓⴽⵯⴼⴰⵢ	ثم سكر سنيدة، مسحوق كريمة الحلويات و الحليب
ⴷⴰ ⴰⵙ ⵙⵏⴰⵎⵖ ⴰⵎⵙⴰⵡⴰⵍ ⵏⵏⵙ	أصحح له حواره
ⵜⴰⵖⴰⵡⵙⴰ ⵢⴰⴹⵏⵉⵏ ⵉⵀⵎⵎⴰⵏ ⴳⴰⵏⵜ ⵜⵜ ⵜⵓⵇⵇⵏⵉⵡⵉⵏ ⴷ ⵎⵉⴷⴷⵏ	شيء آخر مهم هو العلاقات مع الناس
ⵉⵍⵎⵎⴰ ⵏⵎⵎⴰⵜⵜⵉ ⵙ ⵉⵎⵔⵙⵉ ⵢⴰⴹⵏⵉⵏ ⵏⵏⴰ ⵉⴳⴰ ⵜⵉⵎⵏⵛⴽⵉⵏ ⵏ ⵉⴼⵔⴷⵉⵙⵏ ⴰⴷ	ثم ننتقل إلى موضوع آخر ألا وهو نسب هذه العناصر
ⵓⵔ ⵔⴰⴷ ⴱⴱⵉⵖ ⵜⵓⵇⵇⵏⴰ ⵉⵏⵓ ⴷⵉⵎ	لن أقطع علاقتي بك
ⵖⵉⵍⴰ ⵜⵙⵙⵏⵜⵉ ⴰⴷ ⵜⴻⵜⵜⴰⵎⵥ ⴰⴷⵖⴰⵔ ⵏⵏⵙ	الآن بدأ يأخذ مكانه
ⴰⴼⴳⴰⵏ ⵉⵍⵍⴰ ⴼⵍⵍⴰⵙ ⴰⴷ ⵢⴰⴼ ⴰⴽⵓⴷ ⵉ ⵜⵓⵇⵇⵏⵉⵡⵉⵏ ⵏⵏⵙ ⴷ ⵡⴰⵢⵢⴰⴹ	الشخص يجب عليه أن يجد وقتا لعلاقاته مع الآخر
ⵍⴽⵉⵡⵉ	لكيوي
ⵉⴹⴱⵚⵉⵍⵏ ⴰⴷ ⵔⴰⴷ ⵜⵏ ⴰⵙⵔⵖ ⴰⴼⴰⴷ ⴰⴷ ⴱⴹⵓⵖ ⴽⵔⵉⵎⴰ	هذه الصحون سأحتاجها لتقسيم الكريمة
ⵉⵍⵎⵎⴰ ⴰⴷ ⴽⴰ ⴰⴷ ⴽⴰ ⵉⵙⴽⵔ ⵓⴼⴳⴰⵏ ⵜⴰⵎⵀⵍⵜ ⵏ ⵓⴼⵍⴰⵢ	مما يعني أنه بمجرد إجراء الشخص للعملية الجراحية
ⵙⵔⵙⵖ ⴱⵍⵍⴰⵙ ⴰⴹⴱⵙⵉⵍ	أضع عليها الصحن
ⴷ ⵜⵥⴹⴰⵕ ⴰⴷ ⵜⵉⵍⵉ ⴰⵡⴷ ⴳ ⵜⵉⵏⵎⵍ ⴷ ⵓⵙⵔⴰⴳ ⵏⵏⵙ ⵉⴳⴰ ⴰⵙⴳⵎⴰⵏ	وقد تكون في المدرسة أيضا وسببها تربوي
ⵉⵍⵎⵎⴰ, ⵉⵇⵇⴰⵏ ⴷ ⴰⴷ ⵏⵍⵎⴷ ⴷ ⴰⴷ ⵏⵙⵙⵍⵎⴷ ⵉ ⵜⴳⵔⵔⴰⵡⵜ ⵏⵏⵖ ⵎⴰⵏⵎⴽ ⵜⴻⵜⵜⴽⴽⵙ	لذا، يجب أن نتعلم ونعلم عقلنا كيف يتخلص
ⵔⵏⵓⵖ ⵊⵉⵏⵡⴰⵣ	أضيف الجينواز
ⵢⴰⵀ, ⵉⵇⵇⴰⵏ ⴷ ⴰⴷ ⵏⵉⵜⵜⵉ ⵙⴳ ⵓⴳⵍⵓⵜⵉⵏ ⴳ ⵓⵏⴳⵔⴰⵡ ⴰⵎⵙⴰⴷⵓⵔ	نعم يجب تجنب الغلوتين في النظام الغدائي
ⵖⵉⵍⴰ ⵔⴰⴷ ⵏⴼⵜⵓ ⴷⴰⵔ ⵓⵍⵜⵎⴰ ⵜⵓⴷⴰ ⴷ ⵛⵛⵉⴼ ⵃⵎⴰⴷ	الآن سننتقل إلى الأخت تودا والشيف حماد
ⴷ ⵓⵎⵓⵔⵙ, ⵓⵔ ⵙⵉⵙ ⵙⵏⴰⵎⴽⵖ ⵖⵉⴷ ⴰⵎⵓⵔⵙ ⴰⵏⵎⵍⴰⵏ ⵀⵍⵍⵉ	والنجاح لا أعني به هنا النجاح الدراسي فقط
ⴷⴰ ⵜⵜⵉⵏⵉⵏ ⵎⴰⵙ ⵥⵕⴰⵏ ⵍⵍⵉⴳ ⴷⴰ ⴼⵜⵜⵓⵏ ⵡⴰⵔⵔⴰⵡⵏ ⵏⵏⵙⵏ	يقولون أنهم لاحظوا أثناء مشي أبنائهم
ⵉ ⵢⵉⵎⵉⵥ ⵏ ⵡⴰⵔⵔⴰⵣ ⵏ ⵡⵓⴼⵓⵖ ⵙⴳ ⵜⵡⵓⵔⵉ	للحصول على تعويض عن الخروج عن العمل
ⴳ ⵎⵏⵏⴰⵡⵜ ⵜⴽⴽⴰⵍ ⵏⵏⵉⵖ ⴰⵙ ⴰⴷ ⵉⵢⵉ ⵉⵙⵙⵏⴼⵍ ⴰⵡⵔⵉⴽ	في مرات عديدة طلبت منه ان يغير لي الشخصية
ⴰⴽⵔⴽⵏⵏⴰⵢ	القرنبيط الأخضر
ⴽⵓⴷⵏⵏⴰ ⵜⵜ ⵏⵙⵙⵉⵣⴷⴳ ⵎⵍⵉⵃ	بعد أن نقوم بتنظيفها جيدًا
ⵢⴰⵀ ⴰⵢⴰⴷ ⵉⴳⴰ ⴰⵣⴳⴰⵍ, ⵉⵇⵇⴰⵏ ⴷ ⴽⵓ ⵢⴰⵏ ⴰⴷ ⴷⴰⵔⵙ ⵜⴰⴽⵕⴹⴰⴹⵜ ⵏⵏⵙ	نعم هذا خطأ، يجب أن تكون لكل واحد فرشاته الخاصة
ⵎⴰⵕⵕⴰ ⴳⴰⵏⵜ ⵜⵉⵎⵢⵓⵔⵉⵏ ⵉⵥⴹⴰⵕⵏ ⴰⴷ ⵙⵔⴳⵏⵜ ⴰⴽⴰⵏⵚⵉⵕ ⴰⴷ ⵏⵖ ⴰⵏⴰⵡⵏ ⵢⴰⴹⵏ ⵏ ⵓⴽⴰⵏⵚⵉⵕ	كلها عادات قد تسبب هذا السرطان أو أنواع أخرى من السرطان
ⴱⴰⴱⴰ ⴷ ⵉⵎⵎⵉ ⴷ ⵡⴰⵢⵜⵎⴰ	الأب والأم والإخوة
ⵉⵀⵎⵎⴰ ⴰⴷ ⵏⵔⴰⵔ ⵜⴰⵢⵏⵉⵜ ⵉ ⵓⵢⴰⵏⵏ	من المهم الإنتباه لذلك
ⵉⴳ ⵓⵔ ⵜⵖⵔⵉⴷ ⴳ ⵓⵣⵎⵣ ⴰⴷ	فإن لم تكن متعلما في هذا العصر
ⴰⵎⵥⵖ ⵢⴰⵜ ⵜⵙⵎⵖⵓⵔⵜ ⴰⵙⴳⴳⵯⴰⵙ ⵏ 1988	وحصلت على جائزة سنة 1988
ⵡⴰⵏⵏⴰ ⵉⵔⴰⵏ ⴰⴷ ⵉⵙⴽⵔ ⴰⵙⵏⴼⴰⵔ ⵏⵏⵙ	من يرغب بإنشاء مشروعه
ⴷ ⵓⵔ ⴷⴰ ⴳⵉⵙ ⵜⵜⵎⵓⵔⵓⵙⵏ	ولا ينجحون فيها
ⴷ ⵏⵜⵜⵏⵉ ⵓⵔ ⴷⴰ ⵙⵔⵓⴳⵏ ⵜⵉⴼⴼⵓⵔⴽⴰ ⴰⵛⴽⵓ ⴳⵉⵙⵏ ⵜⵉⵎⵜⵜⴰⵡⵉⵏ ⵜⵉⴳⴰⵎⴰⵏⵉⵏ	وهي لا تسبب الحساسية لأنها تحتوي على المواد الطبيعية
ⴳ ⵜⴳⵉⵔⴰ ⵡⴰⵍⵍⵉ ⵉⵀⵎⵎⴰⵏ, ⴰⵙⴳⴰ ⴰⵏⵉⵎⴰⵏ	وأخيرا وهو الأهم، الجانب النفسي
ⵖⵉⴷ ⴰⵔ ⵏⵙⴰⵡⴰⵍ ⴱⴰⵀⵔⴰ ⵖⴼ ⵉⵄⵔⵔⵉⵎⵏ ⴷ ⴰⵡⴷ ⵜⵉⵎⵖⴰⵔⵉⵏ	هنا نتحدث كثيرا عن الشباب والنساء أيضا
ⴷ ⵔⴰⴷ ⵜⵜ ⵏⵙⵙⵎⵔⵙ ⴳ ⵓⵙⴽⵙⴼ	وسنستعملها في التحلية
ⴷ ⵔⴰⴷ ⵏⴰⵙⵔ ⵜⵉⵍⵎⴹⴰⴹⵉⵏ	وسنحتاج لقفازات
ⵢⴰⵀ ⵜⵓⴳⵜⵜ ⴷⴰ ⵜⵜ ⵙⵎⵢⵉⴼⵉⵢⵏ ⴷ ⵓⵊⴳⵓⴳⵍ ⵏ ⵜⵖⵕⴰⴹ	نعم العديد يفضلها مع تدلي للأكتاف
ⴷ ⴰⴷ ⵉⵜⵜⵓ ⵎⴰⵙ ⴷⴰ ⵉⵣⵣⵔⴰⵢ ⵉⵔⵉⵎ	وينسى أنه يجتاز الامتحان
ⵙ ⵉⵎⴽⴰ ⴷⴰ ⵙⵎⵓⵏⴰⵖ ⴳⵔ ⵉⴽⵯⵍⴰⵏ ⴳ ⵓⵕⵛⴰⵎ	هكذا أمزج بين الألوان في الزخرفة
ⴰⵛⴽⵓ ⴹⴰⵕⴰⵜ ⴰⵙⴽⴽⵉⵔ ⵏ ⵜⵎⵀⵍⵜ ⵏ ⵓⴼⵍⴰⵢ	لأن بعد إجراء العملية الجراحية
ⵏⴰⵙⵉ ⴷ ⴰⵙⴽⵜⵔ	نأخد الحشوة
ⴰⴼⴰⴷ ⴰⴷ ⵏⵙⵙⵏ ⵉⵙ ⵉⵍⵍⴰ ⵓⴱⴰⴽⵜⵉⵔⵢⴰ ⵏⵖ ⵓⵀⵓ	لمعرفة تواجد البكتيريا من عدمها
ⴷⴰⵔⵙ ⴰⴹⴰⵕ ⴰⴼⵍⵡⴰⴹ	لديه قدم مسطحة
ⵢⴰⵀ, ⴰⴱⵔⴰⵢ ⴷⴰ ⵉⵜⵜⴱⵓⵅⵎⵓ	نعم فالجرح يتعفن
ⴷ ⵙⴳⵉⵙⵏ ⴰⵙⵎⵎⴰⵎ ⵏ ⵍⵉⴱⵡⵉⴽ	ومنها حمض ليبويك
ⵜⵙⵙⵍⵎ ⴰⵖ ⵢⴰⵜ ⵜⵎⵙⵉⵔⵜ ⵎⴰⵙ ⴷ ⴰⴱⵓⴽⴰⴹ ⵉⵥⴹⴰⵕ ⴰⴷ ⵉⵣⵔⵉ ⵜⵉⴱⴱⴰⵢⴹⴰⵕⵉⵏ	وعلمتنا درسا أن المكفوف يمكنه تجاوز كل العقبات
ⵉⵙ ⵉⵥⴹⴰⵕ ⴰⴷ ⴳⵉⵙ ⵏⵙⵙⴽⵛⵎ ⴰⵡⴷ ⵉⵙⵍⴽⵉⵏⵏ ⴷ ⵉⴷⵉⴱⵍⵓⵎⵏ ?	هل بإمكاننا إدراج الشواهد والديبلومات ضمنها كذلك ؟
ⴷⴰ ⴰⵙ ⵜⴻⵜⵜⵉⵏⵉⴷ ⴽⵔⴰ ⵢⵉⵏⵉ ⵓⵀⵓ	تطلب منه شيئًا فيقول لا
ⵉⵎⵖⵔⵉⴱⵉⵢⵏ ⴰⴽⴽⵯ ⵔⴰⴷ ⴰⵡⵙⵏ ⴳ ⵓⵙⵏⵎⴰⵍⴰ ⵏ ⵓⵎⵓⵙⵙⵓ ⴰⴷ	وجميع المغاربة سيساهمون في تنظيم هذه التظاهرة
ⴼⵔⴽⵖ ⵙⵓⵍ ⵎⴰⵙ ⴷ ⴽⵓⴷⵏⵏⴰ ⵜⵍⴽⵎⴷ 16 ⵏ ⵓⵙⴳⴳⵯⴰⵙ	أدركت بعد ذلك أنه حين تبلغ 16 سنة
ⵙ ⵓⵙⴽⵛⵎ ⵏ ⵓⵣⵡⵓ ⵙⴳ ⵜⵏⵣⴰⵔ	من خلال إستنشاق الهواء من الأنف
ⴷⴰ ⴰⴽⴽⵯ ⵏⵜⵜⵣⴳⴰⵍ ⴽⵓ ⴰⵙⵙ	جميعنا نخطئ يوميا
ⴷ ⴽⵓ ⵢⴰⵏ ⴷⴰⵔⵙ ⴰⵖⴰⵡⴰⵙ ⵏⵏⵙ ⵉⵥⵍⵉⵏ	ولكل برنامجه الخاص
ⵉⵥⴹⴰⵕ ⴰⴷ ⴷ ⵢⴰⵛⴽ ⵢⴰⵏ ⵉⵙⴽⴰⵔⵏ ⵜⵓⵏⵏⵓⵏⵜ ⵢⵉⵔⵉ ⴰⴷ ⵉⵙⵏⵔⵏⵉ ⵜⴰⵙⴰⴽⴰⵢⵜ ⵏⵏⵙ ⵜⴰⵏⴽⵙⵓⵎⵜ	قد يأتي ممارس للرياضة ويرغب في تنمية كتلته العضلية
ⴽⵔⴰ ⵏ ⵜⴽⴽⴰⵍ ⴷⴰ ⵉⴼⴼⴰⵍ ⵓⵢⴰⴷ ⵜⴰⵣⵔⵉⵔⵜ ⵜⵓⵣⴷⵉⵔⵜ ⴳ ⵓⴼⴳⴰⵏ	في بعض الأحيان يخلف هذا أثرا سلبيا على الشخص
ⵎⴰⵛⴰ ⵉⴳⴰ ⵙⴳ ⵜⵎⵙⵙⵓⵢⵉⵏ ⵏⵏⴰ ⵙ ⵉⵜⵜⵡⴰⵙⵙⵏ ⵍⵎⵖⵔⵉⴱ	لكن أصبح من المشروبات التي يشتهر بها المغرب
ⴷ ⵔⴰⴷ ⵜⵏ ⴰⴽⴽⵯ ⵏⵙⵎⵔⴽⵙ	و نخلط الكل
ⵉⵎⴰⵏⵏⴰⵢⵏ ⵏⵏⵖ ⵉⵥⵉⵍⵏ ⴰⵣⵓⵍ	مشاهدينا الكرام مرحبا
ⵓⵔ ⴷ ⴰⴷ ⴽⴰ ⵜⴹⴼⵕⴷ ⵖⵙ ⴰⵖⴰⵡⴰⵙ ⵎⵉⵏ ⵜⴰⵢⴰⴼⵓⵜ	و ليس أن تتبع فقط الخطة دون فائدة
ⴷ ⵍⵍⵉⴳ ⵏⵙⵙⵏ ⵜⵉⴼⵔⵉⵙⵉⵏ ⵏ ⵜⵎⵖⴰⵔⵉⵏ ⴳ ⵍⵎⵖⵔⵉⴱ	وبحكم معرفتنا بخصائص النساء في المغرب
ⵢⵓⵙⴰⵔ ⵜ ⵓⴼⴳⴰⵏ ⵙ ⵜⵖⴰⵔⴰⵙⵜ ⵜⴰⴽⵓⵢⴰⵙⵙⴰⵜ	يحتاجها الإنسان بشكل يومي
ⵙⵍⴰⵡⴰⵏ ⴰⴽⴽⵯ ⴰⵏⴰⵡ ⴰⴷ ⵏ ⵜⵥⵓⵕⵉ ⵉⵀⵎⵎⴰ ⴱⴰⵀⵔⴰ	بالأخص أن هذا النوع من الفن مهم جدا
ⴰⵙⵖⵓⴷⵓ ⵍⵍⵉ ⵙⴽⴰⵔⵖ	التجميل الذي أقوم به
ⴷ ⵍⵍⵉⴳ ⵏⵙⵓⵜⵜⴰ ⴰⴽⵓⴷ ⵏ ⵓⵙⵔⴰⵙ ⵏ ⵓⵎⵜⵛⵓ ⴷ ⵎⴰⵏⴰⴳⵓ ⵔⴰⴷ ⵜ ⵉⴷ ⵏⵙⵙⵓⴼⵖ ⵙⴳ ⵓⴼⵕⵕⴰⵏ	و لأننا حددنا وقت تقديم الطعام و متى نخرجه من الفرن
ⴰⵢⴰⴷ ⴰ ⵖⴼ ⴷⴰ ⵜⵜⵏⴼⵍⴰⵍⴰⵏⵜ ⵜⵖⴰⵡⵙⵉⵡⵉⵏ ⵣⵓⵏ ⴳⴰⵏⵜ ⵜⵉⴷⵜ	لهذا تبدو الأشياء وكأنها حقيقية
ⵏⵙⵏⵙ ⵜ ⵉⵙⴳⵉⵡⵏ ⴰⴽⴽⵯ ⵏ ⵜⵓⴷⵔⵜ ⵏⵏⵖ	ونطبقه في جميع مناحي حياتنا
ⵏⴳⴰ ⵉⵏⴱⴳⵉⵡⵏ ⴰⵙⵙ ⴰⴷ ⴷⴰⵔ ⵎⴰⵙⵙⴰ ⵅⴰⴷⵉⵊⴰ ⵃⴽⵔⵓ	نحن ضيوف اليوم عند السيدة خديجة حكرو
ⴷ ⴷⴰⵔⵙ ⵉⴹⵉⵚ ⵏ ⵎⴰ ⵉⵙⴽⴰⵔ ⵓⵎⵙⵙⴳⵎⵉ ⴳ ⵓⵙⴳⴳⵯⴰⵙ	ولها وقع ما يفعله المربي خلال سنة
ⵙⴳ ⴽⵔⴰ ⵏ ⵢⴰⵏ ⵏⵖ ⵉⴷⵖⴰⵔⵏ ⵢⴰⴹⵏⵉⵏ	من شخاص أو أماكن أخرى
ⴷ ⵓⵔ ⴷ ⵉⴽⴽⵉ ⵓⵢⴰⵏⵏ ⵜⴰⴱⴰⵙⵍⵉⵜ	ولا يتعلق الأمر بالوقاحة
ⵎⴰⵛⴰ ⵜⵉⵎⵔⵙⵍⵜ ⵏ ⵜⵉⵏⵎⵍ ⵏⵜⵜⴰⵜ ⴰⵢⴷ ⵉⵜⵜⵓⵔⴰⵔⵏ ⵜⴰⵎⵍⵉⵍⵜ ⵉⵀⵎⵎⴰⵏ	لكن مؤسسة المدرسة هي التي تلعب الدور الأهم
ⵎⴰⵢⴷ ⴳⴰⵏⵜ ⵜⵎⵉⵜⴰⵔ ⵏⵏⵙ ⵉⴼⴰⵡⵏ?	ما هي أعراضه الواضحة؟
ⵜⴰⴷ ⴰⵢⴷ ⵉⴳⴰⵏ ⵜⴰⵡⵉⵍⴰ ⵜⴰⵎⴳⴳⴰⵔⵓⵜ ⵏ ⵍⵃⵔⵛⴰ	هذا هو الشكل النهائي للحرشة
ⵜⵍⵍⴰ ⵜⴼⵔⵓⵅⵜ ⵜⵉⴳⵉⴳⵉⵍⵜ ⵙ ⵓⵎⴷⵢⴰ	هناك فتاة يتيمة مثلا
ⴳ ⵜⵉⵣⵉ ⴰⵏⵏ ⴽⴽⵉⵖ ⵜⵜ ⵉⵏⵏ ⴷⴰ ⵏⵏ ⵜⵜⴽⴽⴰⵖ ⴷⴰⵔ ⵉⵎⵎⵉ ⴳ ⵓⵙⵓⵏ	في تلك الفترة كنت أزور والدتي في القرية
ⴷ ⵓⵢⴰⴷ ⴰⵢⴷ ⴷ ⵉⵇⵇⴰⵏⵏ ⴰⴷ ⵜ ⵏⵙⵙⵏ	وهو ما يجب أن نعرفه
ⴰⵢⴰⵏⵏ ⴰ ⵖⴼ ⴰⵔ ⵙⵎⵎⵜⴰⵔⵖ ⴰⴷ ⵓⵔ ⵙⵙⵎⵔⴰⵙⵏ ⵉⴱⵓⵔⴽⵙⵏ ⴰⵏⵏ ⵖⵉⵏⵏ ⵉⵍⵍⴰⵏ	لذلك أوصي بعدم إستعمال تلك الأحذية المتواجدة هناك
ⵢⴰⵀ	بالفعل
ⴷ ⵙ ⵓⵏⵛⵜ ⵏⵏⴰ ⵏⴼⵜⴰ ⵙ ⵉⴼⴼⵓⵙ, ⴷⴰ ⵜⴻⵜⵜⵉⴳⵓⵜ ⵜⵙⴳⵉⵏⵉ ⵏ ⵡⴰⵜⴰⵢ	وكلما إتجهنا نحو الجنوب يشتد سواد الشاي
ⴰⵙⵔⴰⴳ ⵏ ⵓⵢⴰⴷ ⵉⴳⴰ ⵜ ⵏⴽⴽⵏⵉ	السبب في ذلك هو نحن
ⴰⴷ ⵙⴰⵡⴰⵍⵏ ⵖⴼ ⵉⵡⵉⵜⵙⵏ ⴷ ⵎⴰⵢⴷ ⵉⵜⵜⵉⵔⵉ ⴷ ⵎⴰⵢⴷ ⵜ ⵉⵙⵙⵓⵙⵓⵎ	يتحدثان عن إبنهما وميولاته وما يروقه
ⵜⵉⴷ ⴰ ⵉⴳⴰⵏ ⵜⵉⵙⵓⵔⵉⴼⵉⵏ	هذه هي الخطوات
ⴷ ⴰⵡⴷ ⵜⵉⴽⵏⵉ ⵓⵔ ⴷⴰ ⵜⴻⵜⵜⵉⵍⵉ	وحتى القوس لا يكون موجودا
ⴷⴰ ⵜⴻⵜⵜⵖⴰⵎⴰ ⵜⵉⵣⵉ ⵉⵍⴽⴽⵎⵏ ⴰⵢⵢⵓⵔ	تبقى لمدة تصل لأشهر
ⵉⵍⵎⵎⴰ ⵢⵉⵎⵖⵓⵔ ⵢⴰⵍⵉ ⵙ ⵓⴼⵍⵍⴰ	ثم يزداد ويصعد نحو الأعلى
ⵔⴰⴷ ⵏⵎⵎⴰⵜⵜⵉ ⵖⵉⵍⴰ ⴰⴽⴷ ⵜⵓⴷⴰ ⴷ ⵛⵛⵉⴼ ⵃⵎⴰⴷ	سننتقل الآن مع تودا و الشيف حماد
ⵜⴽⴽⵙⴷ ⵓⵜⵛⵉ ⴷ ⴰⵡⴷ ⵜⵉⵙⵙⵉ	وتمتنع عن الأكل والشرب أيضا
ⵓⴷⵓⵣ ⴰⴷ ⴷⴰ ⴷ ⵉⵜⵜⴽⴽⴰ ⵜⴰⵥⴰⵢⵜ ⵏⵏⵖ	هذا الضغط ينتج عن وزننا
ⴰⴼⴰⴷ ⴰⴷ ⵎⵢⴰⵔⵏ ⵉⵊⵉⵏⵏ	لكي تتعود الجينات
ⴷ ⴰⵡⴷ ⵛⵛⴽⵯⵍⴰⵟ ⴰⵙⴳⴳⴰⵏ	وكذلك الشكولاطة السوداء
ⴷ ⵓⵢⴰⴷ ⵔⴰⴷ ⴰⴽ ⵉⵙⵔⴳ ⴳ ⵜⴰⵙⵙⴰⵙⵜ ⴷ ⵓⵏⵏⵓⵖⵊⴼ	وهذا سيسبب لك التوثر والقلق
ⴰⵛⴽⵓ ⴰⵢⴰⵏⵏ ⴷⴰ ⵉⵔⵏⵏⵓ ⴳ ⵜⵎⵍⴷⵉⵡⵉⵏ	لأن ذلك يزيد من الفرص
ⴰⵎⵓⴽⵔⵉⵙ ⵏⵏⴰ ⵉⵍⵍⴰⵏ ⴳ ⵡⴰⵢⵢⵓⵔ ⵏ ⵕⵎⴹⴰⵏ	المشكل القائم في شهر رمضان
ⴰⵡⴷ ⵜⵉⵎⵍⵙⵉⵜ, ⵓⵔ ⵉⵥⴹⵉⵕ ⴰⴷ ⵉⵍⵙ ⴽⵔⴰ ⵏ ⵜⵎⵍⵙⵉⵜ	حتى اللباس لا يستطيع أن يرتدي زيا
ⵢⵉⵏⵉ ⴰⵙⵏ ⵓⵙⵍⵎⴰⴷ ⵜⴰⵖⴰⵡⵙⴰ ⵢⴰⴹⵏⵉⵏ	ويأمرهم الأستاذ بشيء آخر
ⵢⴰⵀ ⵔⴰⴷ ⵏⵙⴰⵡⵍ ⴰⵙⵙ ⴰⴷ ⵖⴼ ⵡⴰⵍⴼⴰⴼⵏ	نعم سنتحدث اليوم عن الستائر
ⵏⴽⴽⵙ ⵜⵏ ⵙⴳ ⵉⴳⴳⵉ ⵏ ⵡⴰⴼⴰ	نزيلهما من فوق النار
ⵉⵍⵎⵎⴰ ⴰⵖⵔⵓⵎ ⵉⵙⵍⵉⵏ	ثم الخبز المحمص
ⴷ ⵜⵖⴰⵡⵙⴰ ⵜⴰⴱⵏⵏⴰⵏⵜ ⴷⴰ ⵜⴻⵜⵜⵖⴰⵎⴰ ⴱⵍⴰ ⴰⵣⴰⵍ	والشيء المجاني يبقى بلا قيمة
ⴰⴼⴰⴷ ⴰⴷ ⴰⵖ ⵜⴼⴽ ⵜⴰⵡⵍⴰⴼⵜ	من أجل أن تعطينا الصورة
ⵔⴰⴷ ⵏⴼⵜⵓ ⵖⵉⵍⴰ ⴷⴰⵔ ⵜⵓⴷⴰ ⴷ ⵛⵛⵉⴼ ⵃⵎⴰⴷ	سننتقل الآن عند تودا و الشيف حماد
ⵍⵍⵉ ⵏⵙⵙⵎⵔⴰⵙ ⴱⴰⵀⵔⴰ ⴰⵛⴽⵓ ⵉⴳⴰ ⵓⴱⵖⵉⵔ ⴱⴰⵀⵔⴰ	الذي نستخدمه كثيرا لأنه مهم جدا
ⵉⵇⵇⴰⵏ ⴷ ⵣⵡⴰⴷ ⴰⴷ ⵙⵙⵏⵖ ⵎⴰⵙ ⵍⵍⴰⵏ ⵡⴰⵏⴰⵡⵏ ⴰⴷ ⵏ ⵜⴰⵢⵔⵉ	يجب أولا أن أعرف بوجود هذه الأنواع من الحب
ⴰⵎⴰⵜⴰⵔ ⵏ ⵜⵙⴰⴽⴰⵢⵜ ⵏ ⵜⴼⴽⴽⴰ	مؤشر الكتلة الجسمية
ⵓⵔ ⵜⵥⴹⴰⵕⴷ ⴰⴷ ⵜⵎⵎⴹⵉⴷ ⴰⵣⴰⵜⵉⵎ ⵏ ⵡⴰⵔⴳⴰⵏ ⴷ ⵓⵎⵍⵓ	لا يمكنك تذوق زيت أركان وأملو
ⴰⴼⴳⴰⵏ ⴷⵉⵜⵉ ⵉⵎⵣⴰⵔⴰⵢⵏ ⴷⴰ ⵉⵢⵉ ⵉⵙⵙⵍⵎⴰⴷ ⵜⴰⵖⴰⵡⵙⴰ ⵜⴰⵎⴰⵢⵏⵓⵜ	الفرد الذي يختلف معي يعلمني شيئا جديدا
ⵎⴰⵛⴰ ⵉⵙ ⵉⵖⵉⵢ ⴰⴷ ⵜ ⴷⴰⵖ ⵉⵙⵎⴰⵀⵍ ⵜⵉⴽⴽⵍⵜ ⵢⴰⴹⵏⵉⵏ ⵏⵖ ⴷ ⵓⵀⵓ ?	لكن هل بمقدوره تشغيله مرة أخرى أم لا ؟
ⵜⴰⵙⵍⵎⴰⴷⵜ ⵎⴰⵏⵉⵎⴽ ⵙ ⵏⵓⴼⴰ ⴰⴷ ⵏⵙⵙⴳⵎⵉ ⴰⵣⵣⴰⵏ ⵖⴼ ⵓⵎⵙⴰⵔⵓⴼ ?	أستاذة كيف بإمكاننا أن نربي الطفل على التسامح؟
ⵔⴰⴷ ⵉⵙⵇⵙⴰ ⴰⵎⵙⴰⵙⴼⵔ ⴷ ⵓⵎⵙⴳⵏⴰⴼ ⵏⵏⵙ	سيسأل الصيدلي وطبيبه الخاص
ⵉⵔⵉⵔⵖ ⴳ ⵜⴳⵔⴰⵡⵜ ⴷ ⴳ ⵓⵙⴰⵔⴰⴳ ⵏ ⴱⵕⵕⴰ ⴷ ⴳ ⵜⵏⵣⵡⴰⵢⵜ	قمت بالغناء في البلدية وفي مسرح الهواء الطلق وفي الإذاعة
ⴷ ⴽⵓⴷⵏⵏⴰ ⵜⵔⴰ ⴰⴷ ⵜ ⵜⵙⴱⴷⴷ ⴷⴰ ⵜⵙⴽⴰⵔ ⴰⵢⴰⵏⵏ ⵉⵎⵉⴽⴽ ⵙ ⵉⵎⵉⴽⴽ	وحين تريد أن توقفه تعمل على ذلك تدريجيا
ⵙ ⵜⵎⵔⵏⵉⵡⵜ ⵏ ⵓⴽⴰⵍⵙⵢⵓⵎ	بالإضافة للكالسيوم
ⵎⴰⵛⵛ ⴷⴰ ⴰⵙ ⵏⵙⵙⵍⵎⴰⴷ ⵉⴼⵓⴽⵙⵏ	بل نعلمه المهارات
ⵏⵙⵔⵙ ⵜⵜ ⴰⴷ ⵜⵇⵇⴰⵔ	نضعها لتجف
ⵜⵏⴼⵍⴷ ⵙⴳ ⵓⴼⴳⴰⵏ ⴰⵏⴼⵔⴰⵢ ⵉⵙⵔⵓⵙⵏ ⵉⴱⴹⵉⵜⵏ ⴰⵔ ⵡⴰⵢⵢⴰⴹ ⵉⴷⴽⵜⵏ	فتتحول من شخص إنفعالي يصدر أحكاما مطلقة إلى آخر هادئ
ⴷ ⴷⴰ ⴷ ⵙⴳⵉⵙⵏⵜ ⵉⵜⵜⴼⴼⵖ ⵓⴽⴰⵕⴱⵓⵏ	و ينبعث منها الكربون
ⵔⴰⴷ ⵏⴱⴱⵉ ⴰⵡⴷ ⵜⴰⵥⴰⵍⵉⵎⵜ	سنقطع البصل كذلك
ⴰⵔ ⵙⵙⵉⵜⵉⵎⵖ ⴰⴷ ⵉⵙⵙⵉⵙⴼⵉⵡ ⵕⴱⴱⵉ ⵉⵖⴰⵔⴰⵙⵏ ⵏⵏⵖ	أتمنى أن ينير الله دروبنا
ⴷ ⵙⴳ ⵓⵙⴳⴰ ⵢⴰⴹⵏⵉⵏ ⴷⴰ ⵜⴻⵜⵜⵃⴹⵓ ⵉⴽⵯⵍⴰⵏ ⵏⵏⵙ	ومن جهة أخرى تحتفظ بألوانها
ⵉⵎⴽⵍⵍⵉ ⵉⵙⵔⵓⴳ ⴰⵏⵓⴽⵎⵓ ⴷ ⵓⵔ ⵜⴷⴳⴳⵉⴷ ⵜⴰⵡⵉⵍⴰ ⵏⵏⴽ	كما أنها تسبب بالإكتئاب و لا تكون راضيا على شكلك
ⵉⵙ ⴷ ⵢⵓⵙⴼ ⵢⴰⵖ ⵜ ⴽⵔⴰ?	هل يوسف أصابه مكروه؟
ⴰⴷ ⴷ ⵏⴰⵙⵉ ⵜⵉⴼⵉⵍⵜ ⵉⵍⵎⵎⴰ ⵏⵙⵙⴽⵛⵎ ⵜⵜ ⵙ ⵓⴼⵕⵕⴰⵏ	نأخذ الصفيحة وندخلها إلى الفرن
ⵔⴰⴷ ⵏⵙⵙⵎⵔⵙ 33 ⴰ.ⴱ.ⵙ	سنستعمل 33 أ.ب.س
ⵎⴰⵢⴷ ⴳⴰⵏ ⵎⴷⴷⵏ ⵍⵍⵉ ⵉⵙⵓⵊⵊⵉⵢⵏ ⵙ ⵜⴰⵙⵙⵎⵉⵡⵉⵏ ⵜⵉⵛⵉⵏⵡⵉⵢⵉⵏ?	من هم الأشخاص الذين يعالجون بالإبر الصينية؟
ⵜⵥⴹⴰⵕⵎ ⴰⴷ ⵏⵏ ⵜⵔⵏⵓⵎ ⵜⵓⵎⵏⵜ ⵏⵏⴰ ⵜⵔⴰⵎ ⴰⵎⵎ ⵜⴰⵣⵡⵍⵜ	يمكنكم إضافة النكهة التي تريدونها كالفراولة
ⵎⴷⴷⵏ ⵏⵏⴰ ⵓⵔ ⵉⴹⴼⵉⵕⵏ ⴰⵏⴳⵔⴰⵡ ⴰⵎⵙⴰⴷⵓⵔ ⴷ ⴷⴰⵔⵙⵏ ⵙⵉⵍⵢⴰⴽ	الأشخاص الذين لا يلتزمون بالحمية وهم يعانون السيلياك
ⴰⵙⴰⴼⴰⵔ ⵏⵏⵙⵏ ⴳ ⵓⵎⵣⵡⴰⵔⵓ ⵉⴳⴰ ⵜ ⵓⵙⵙⵓⴽⴼ ⵏⵏⵙⵏ	علاجها في الأول يكون باجتثاثها
ⴷⴰ ⵜⴻⵜⵜⵓⵙⴽⴰⵔ ⵙ ⵉⴽⴰⵙⵏ ⵏ ⵙⵙⵉⵍⵉⴽⵓⵏ	فهي تمارس بواسطة كؤوس السيليكون
ⵓⵔ ⴷ ⵖⴰⵔ ⵏⴽⴽⵏⵉ ⴰ ⵉⵙⵙⴳⵎⴰⵢⵏ	فلسنا من نربي وحدنا
ⵜⵏⵏⵓⵔⵣ ⴰⴷ ⵜⴰⴼ ⵜⵓⴷⵔⵜ ⵢⵓⴼⵏ	و أملا في أن تجد حياة أفضل
ⵉⵥⴹⴰⵕ ⵡⴰⴽⴰⵎ ⴰⴷ ⵢⴰⵡⵙ ⵉⴳ ⵉⵍⵍⴰ ⵓⵏⵓⵙⵔⵓ	بإمكان التحفيز أن يساعد إن كان هناك نقص
ⴽⵔⴰ ⵏ ⵜⴽⴽⴰⵍ ⴷⴰ ⵜⴻⵜⵜⵉⵍⵉ ⵜⵎⵍⴷⴰ ⵉ ⵓⵙⵎⴰⵢⵏⵓ ⵏ ⵜⵓⵇⵇⵏⴰ ⴳⵔ ⵉⵎⵢⵉⵡⵍⵏ	أحيانا تكون فرصة لتجديد العلاقة بين الزوجين
ⵏⴳ ⵏⵏ ⵜⵉⵙⵏⵜ	نضيف الملح
ⵎⴰⵏⵎⴽ ⵉⵜⵜⵔⵎⴰⵙ ⵜⵓⴼⵔⴰⵢⵉⵏ ⵏⵏⵙ ⴷ ⵎⴰⵏⵎⴽ ⴼⵍⵍⴰⵙⵏ ⵉⵙⵏⴼⴰⵍⴰⵢ	كيف يفهم مشاعره وكيف يعبر عنها
ⵉⵍⵎⵎⴰ ⵏⴰⵊⵊ ⵜ ⴰⵔⴷ ⵉⵏⵏⴹⴼⵚ ⵓⴱⵍⵖ ⵏⵏⵙ	ثم نتركها حتى يتضاعف حجمها
ⴷ ⵉⴳ ⵢⴰⴷⵍⵍⵉ ⵔⴰⴷ ⵜⵎⵓⵏⴷ ⴷ ⵢⴰⵏ ⵓⴼⴳⴰⵏ ⵉⵙⴽⴰⵔⵏ ⵜⴰⵇⵇⵓⵔⵜ	وإن كنتِ سترافقين شخصًا يثير الضجيج
ⵍⵍⵉ ⵉⴳⴰⵏ ⵜⵉⵣⵡⵉⵔⵉ ⵏ ⵜⵏⴼⵍⴰⵍⵉⵜ ⵏ ⵓⴱⵔⴰⵢ ⴳ ⵓⴹⴰⵕ	وهي بداية ظهور الجرح في القدم
ⴷ ⴷⴰ ⵜⵙⵙⵏⵡⴰ ⴷ ⴷⴰ ⵜⵙⴰⵡⴰⵍ ⴷ ⵉⵍⵍⵉⵙ ⵏⵖ ⵓⵍⵜⵎⴰⵙ ⴳ ⵜⵉⵍⵉⴼⵓⵏ	وتطهو وتتحدث مع إبنتها أو أختها عبر الهاتف
ⵏⵏⴰ ⵉⵜⵜⴽⴽⵙⵏ ⵢⴰⵜ ⵜⵎⵜⵜⴰ ⵉⵙⵎ ⵏⵏⵙ "ⴰⵎⵓⵙⵉⵙⵜⵉⵢⵉⵏ"	الذي يزيل مادة تسمى أموسيستيين
ⴰⴼⵔⴷⵉⵙ ⵡⵉⵙⵙ ⴽⴽⵓⵥ ⵉⴳⴰ ⵜⴰⵎⵙⵙⵏⴰ ⵏ ⵜⵎⴰⵎⴽⵜ ⵏ ⵓⵎⵢⴰⴳⴳⴰ ⴷ ⵡⵉⵢⵢⴰⴹ	الركن الرابع هو معرفة كيفية التعامل مع الآخرين
ⴷ ⴹⴰⵕⴰⵜ ⵢⴰⵜ ⵜⵉⵣⵉ ⴷⴰ ⵉⵊⵊⵉ ⵓⴱⵔⴰⵢ	وبعد مرور مدة يتعافى الجرح
ⵉⵇⵇⴰⵏ ⴷ ⵜⴰⵡⵓⵔⵉ ⴰⴷ ⴳⵉⵙ ⵉⵍⵉⵏⵜ ⵜⴼⴰⴷⵉⵡⵉⵏ ⴰⴼⴰⴷ ⴰⴷ ⵙⵉⵙ ⵜⵎⵣⵉⵣⵡⵉⵔⴷ ⴳ ⵓⵙⵡⵉⵔ ⴰⵎⴰⴹⴰⵍⴰⵏ	العمل يجب أن يستوفي شروطا لتنافس به على الصعيد العالمي
ⴷ ⵜⴽⵚⵚⴰⴹ ⴰⴷ ⴰⵢⴷ ⵓⵔ ⵉⵜⵜⴰⵊⵊⴰⵏ ⵜⵉⴼⵔⵅⵉⵏ	وهذا الخوف يمنع الفتيات
ⴰⵙⵇⵙⵉ ⵉⵜⵜⵓⴼⴽⴰ ⴰⵎ ⴰ ⵜⴰⴷⵓⴽⵜⵓⵔⵜ, ⴷ ⴰⵡⴷ ⵉ ⴷⴷⵓⴽⵜⵓⵔ ⵄⴰⴱⴷⵓⵍⵍⴰⵀ	هذا السؤال موجه لكِ دكتورة، وكذلك للدكتور عبد الله
ⵜⴰⵏⵎⵎⵉⵔⵜ ⵏⵏⴽ ⵄⴰⴱⴷⵓⵍⵍⴰⵀ ⴱⴰⵀⴰ	شكرا لك عبد الله باها
ⵉⵇⵇⴰⵏ ⴷ ⴰⴷ ⵜ ⵏⵙⴽⵔ	يجب القيام به
ⵓⵔ ⵜⵥⴹⵉⵕⴷ ⴰⴷ ⵜⵙⵏⴼⵍⵉⴷ ⴰⵥⴰⵡⴰⵏ ⵏⵏⴰ ⵜⵙⴽⴰⵔⴷ	لا تستطيع تطوير الموسيقى التي تمارسها
ⴷⴰ ⵜⵜⵓⵙⵎⵔⴰⵙⵏⵜ ⵜⵎⵜⵜⴰⵡⵉⵏ ⴰⴷ ⴳ ⵜⵉⵔⴰⵎ	تستعمل هذه المواد في حصص
ⵉⵍⵎⵎⴰ ⵏⵙⵔⵙ ⵜⵜ ⴳ ⵜⴰⴽⴽⴰ ⵏ ⵓⵖⵔⵓⵎ	ثم نضعها في فتات الخبز
ⴷⴰⵔ ⵛⵛⵉⴼ ⵃⵎⴰⴷ	إلى الشيف حماد
ⴷ ⵍⵍⵉⴳ ⵉⵣⵡⴰ ⵢⵉⵍⴼⵜ ⵏⵏⵙ	وبما أن بشرتها جافة
ⵉⵇⵇⴰⵏ ⵉ ⵡⴰⵏⵏⴰ ⵢⵓⵔⴷⴰⵏ ⵎⴰⵙ ⵢⴰⵖ ⴰⵔⵔⴰⵡⵏ ⵏⵏⵙ	من الضروري بالنسبة لكل من يشك بإصابة أحد أطفاله
ⴷ ⴰⴷ ⵙⴽⴰⵔⵏ ⵜⵓⵏⵏⵓⵏⵜ ⴷ ⴰⴷ ⴹⴼⵕⵏ ⴰⵏⴳⵔⴰⵡ ⴰⵎⵙⴰⴷⵓⵔ ⵉ ⵜⵏⴼⵔⵓⵜ ⵏ ⵜⴼⴽⴽⴰ ⵏⵏⵙⵏ	وأن يمارسوا الرياضة ويتبعون الحمية لسلامة جسمهم
ⵏⵏⴰ ⴷⵉⵜⵉ ⵉⵍⵍⴰⵏ ⴰⵙⵙ ⴰⴷ ⴳ ⵜⴳⵟⵟⵓⵎⵜ ⵏ ⵜⵙⴰⴷⵓⵔⵜ	المتواجد معي اليوم في فقرة التغذية
ⵉⵎⴰⵏⵏⴰⵢⵏ ⵏⵏⵖ ⴱⵔⵔⴽⴰⵜ ⴷⴰⵖ ⴳ ⵓⵖⴰⵡⴰⵙ ⵏⵏⵓⵏ ⵜⴰⴼⴰⵜ	مشاهدينا مرحبا بكم من جديد في برنامجكم تافات
ⵉⵣⴷⵉ ⴷ ⵜⵎⵙⴰⵔⵜ ⵜⴰⴱⵕⵕⴰⵏⵉⵜ	مرتبط بحدث خارجي
ⴰⵙⵙ ⴰⴷ ⵔⴰⴷ ⵏⴼⵜⵓ ⵙ ⵜⵎⵏⴰⴹⵜ ⵏ ⵍⵉⵔⴰⴽ	اليوم سنتوجه اليوم لمنطقة ليراك
ⴰⴼⴰⴷ ⴰⴷ ⵉⴱⵖⵔ ⵉⵖⴼ ⵏⵏⵙ	ليفيد نفسه
ⵎⴰ ⴳ ⴷⴰ ⵜⵜⵓⵙⵎⵔⴰⵙⵏⵜ ⵜⵖⴰⵡⵙⵉⵡⵉⵏ ⴰⴷ ⵍⵍⵉ ⵜⵙⴽⴰⵔⵎ?	فيما تستخدم هذه الأشياء التي تصنعونها؟
ⵜⵉⴼⴰⵙⵉⵡⵉⵏ ⵍⵍⵉ ⵉⴼⴽⴰ ⵕⴱⴱⵉ ⵉ ⵡⴰⵣⵣⴰⵏ ⴰⴷ	الطاقات التي منحها الله لهذا الطفل
ⴰⵙⵡⵓⵏⴼⵓ ⵉⵀⵎⵎⴰ	فالراحة مهمة
ⵉⵖⴰⵍ ⵎⴰⵙ ⴷ ⴰⴷ ⵉⴷⴷⵔ ⵉⴳ ⴰⵎⵥⵍⵓⴹ ⴳ ⵜⴷⴷⵓⵢⵜ	فيعتقد أن العيش فقيرا في الدنيا
ⵏⵏⴰ ⵣⵣⵔⴰⵢⵏ ⵉⵎⴰⵔⴰⵡⵏ ⵉ ⵡⴰⵔⵔⴰⵡⵏ ⵏⵏⵙⵏ	التي يمررها الآباء لأبنائهم
ⴳ ⵜⴳⵟⵟⵓⵎⵜ ⵏ ⵜⴳⵎⵉ ⵜⴰⵏⵉⵎⴰⵏⵜ ⵏ ⵜⵙⴷⴷⵉⵜ ⵏ ⵡⴰⵙⵙ ⴰⴷ	في فقرة التنمية الذاتية لحلقة اليوم
ⴰⵎⵙⴰⴷ ⵏ ⵜⵙⴼⵔⴰⴽ	بإرهاف الحواس
"ⴰⵎⵓⵔ ⵏⵏⴽ ⵉⵙ ⵜⵥⴹⴰⵕⴷ ⴰⴷ ⵉⵢⵉ ⵜⴼⴽⴷ ⴰⴷⵍⵉⵙ ⴰⴷ?	"من فضلك هل يمكنك أن تعطيني الكتاب الفلاني؟"
ⵓⵔ ⵔⴰⴷ ⵏⵉⵏⵉ ⵎⴰⵙ ⵓⵔ ⴷⴰ ⴳⵉⵜⵏⵖ ⵉⵜⵜⵖⴰⵎⴰ	لا يمكن القول بأننا لا نتأثر
ⵜⴰⵏⵎⵎⵉⵔⵜ ⵏⵏⵎ ⴼⴰⵟⵉⵎⴰ	شكرا فاطمة
ⵉⵍⵎⵎⴰ ⴰⵣⵣⵔⴰⵢ ⵙ ⵓⴼⵓⵙ	ثم الفحص باليد
ⴷ ⵡⴰⵣⴰⵍⵏ ⴰⴷ ⵓⵜⵜⴰⵏ ⴳ ⵓⵎⵉⵔⵓ ⵉⵎⴽⵍⵍⵉ ⴰⴽⴽⵯ ⵏⵙⵙⵏ	وهذه القيم محددة في الميتاق كما نعلم جميعا
ⴰⵛⴽⵓ ⴰⴼⴰⴷ ⴰⴷ ⴷ ⵏⴷⵓⵢ, ⵏⵖⵔ, ⴷⴰ ⵏⵙⵙⴰ ⴰⵜⴰⵢ ⵉⴼⵙⵙⵓⵙⵏ	فلكي نستيقظ وندرس، نشرب شايا خفيفا
ⵉⵙ ⵏⵉⵜ ⵜⵥⴹⴰⵕⴷ ⴰⴷ ⵜⵎⵎⵓⴷⴷⵓⴷ ⵉ ⵡⴰⴹⵓ ⵏⵏⴽ ?	هل فعلا تقدر على السفر وحيدا ؟
ⵓⵔ ⵉⴳⵉ ⵜⵉⴳⵉⵔⴰ ⵏ ⵜⵎⵣⴳⵓⵏⵜ ⴷ ⵢⵉⵥⵕⵉ ⵏ ⵓⴳⴷⵓⴷ	ليس نهاية المسرحية ومشاهدة الجمهور
ⴰⴼⴰⴷ ⴰⴷ ⵉⵙⴰⵡⵍ ⵖⴼ ⵓⵏⴼⴰⵍ ⵉⵙⵓⵍⵏ	للحديث عن التغيير المستمر
ⴳ ⵢⴰⵏ ⵡⴰⴽⵓⴷ ⴷⴰ ⵜⵜⴰⵎⵥⵖ ⵓⴷⵎ	في نفس الوقت أشد الوجه
ⵉⴳ ⵉⵖⵎⴰ ⵓⴽⵍⵓ ⵏ ⵜⵖⵎⵉ ⵏ ⵉⵖⵔⴱⴰⵏ	إذا كان لون صباغة الجدران قاتما
ⴰⵛⴽⵓ ⵏⵜⵜⵏⵜⵉ ⴰ ⵉⵣⵡⴰⵔⴰⵏ ⵉⵙ ⵉⵡⵉⵏⵜ ⵜⴰⵢⵏⵉⵜ	لأنها أول ما يلفت الانتباه
ⴽⵓⵍⴰⵊⵉⵏ ⵍⵍⵉ ⵉⴽⵛⵛⵎⵏ ⴳ ⵉⴼⵔⴷⵉⵙⵏ ⵏ ⵜⴳⵔⵛⵓⵛⵜ	الكولاجين الذي يدخل ضمن مكونات الغضروف
ⴰⵛⴽⵓ ⵉⴳⴰ ⴰⴷⵖⴰⵔ ⵏ ⵓⴽⴰⵍⵙⵢⵓⵎ	حيت يعد موضع الكالسيوم
ⴰⵛⴽⵓ ⵣⵉⴽ, ⴰ ⵓⵍⵜⵎⴰ ⴼⴰⵟⵉⵎⴰ ⵥⵥⴰⵀⵕⴰ	لأنه في السابق أختي فاطمة
ⵜⵙⵡⵉⵏⴳⵎⴷ ⵎⴰⵙ ⴷ ⴰⴼⴳⴰⵏ ⴰⵏⵏ ⵓⵔ ⴽ ⵉⴽⵯⵎⵉ ⵙ ⵢⴰⵜ	وتفكر بأن ذلك الشخص لم يؤذك بشيء
ⵎⴰⵛⵛ ⵙ ⵜⵎⴳⵕⵥⵉ ⵓⵔ ⵙⵓⵍ ⵍⵍⵉⵏ	لكن للأسف لم تعد موجودة
ⵉⴳⴰ ⵎⴰⵙ ⵍⵍⴰⵏ ⵎⴷⴷⵏ ⴷⴰ ⵜⵏ ⵏⵙⵓⵊⵊⵉⵢ	هو أن هناك أشخاص نعالجهم
ⴷⴰ ⴰⵙ ⵜⵙⵔⵓⵙⴷ ⵢⴰⵜ ⵜⵙⵓⵖⵍⵜ ⴳ ⵜⴳⵔⵔⴰⵡⵜ ⵏⵏⵎ	تضعين له ترجمة معينة في عقلك
ⵉⴼⵔⵓ ⵜⵉⵎⵇⵕⴰⴹ ⵏ ⵜⵀⵉⵔⵉⵜ	و يدفع أقساط السيارة
ⴷⴰ ⵉⵜⵜⵓⵔⴰⵔ ⵜⴰⵎⵍⵉⵍⵜ ⵉⵅⴰⵜⵔⵏ ⵙⵍⴰⵡⴰⵏ ⴰⴽⴽⵯ ⴳ ⵓⵙⵡⵉⵔ ⵏ ⵢⵉⵍⵎ	فهو يلعب دورا هاما خصوصا على مستوى الجلد
ⵉⵎⴰ ⵏⴽⴽⵏⵉ ⵉⴳ ⵉⴼⵙⵙ ⵡⴰⵣⵣⴰⵏ ⵉⵃⵛⵛⵎ	أما نحن فإذا كان الطفل صامتًا وخجولًا
ⵉⵎⴰⵏⵏⴰⵢⵏ ⵏⵏⵖ ⵉⵥⵉⵍⵏ ⴱⵔⵔⴽⴰⵜ ⵜⵉⴽⴽⵍⵜ ⵢⴰⴹⵏⵉⵏ	مشاهدينا الأفاضل مرحبا مرة أخرى
ⵉⵙⵙⵓⵙⵎ ⵉⵢⵉ ⴰⴷ ⴷⵉⵜⵓⵏ ⵉⵍⵉⵖ ⴰⵙⵙ ⴰⴷ	يسرني أن أكون معكم اليوم
ⵉⵍⵎⵎⴰ ⴰⴷ ⵉⵜⵜⴹⴼⵕ ⵜⵓⴷⵔⵜ ⵏⵏⵙ ⵙ ⵜⵖⴰⵔⴰⵙⵜ ⵜⵓⵏⵣⵉⵍⵜ	وبالتالي يتابع حياته بشكل عادي
ⴳ ⵜⵖⴰⵔⴰⵙⵜ ⵏ ⵓⵙⵡⵉⵏⴳⵎ ⵏⵏⵖ	في طريقة التفكير
ⴽⵓⴷⵏⵏⴰ ⵉⵙⴽⵔ ⵡⴰⵣⵣⴰⵏ ⴽⵔⴰ ⵉⴼⵓⵍⴽⵉⵏ ⴳ ⵜⴳⵎⵎⵉ	حين يقوم الطفل بشيء جيد في المنزل
ⴳ ⵜⵣⵡⵉⵔⵉ ⵉⵍⵍⴰ ⴼⵍⵍⴰⵖ ⴰⴷ ⵏⵙⵙⵏ ⵎⴰⵙ ⴷ ⵜⴰⵙⵙⴰⵙⵜ	في البداية علينا معرفة أن التوتر
ⵜⴼⴽ ⴰⵙ ⵜⵉⵍⴻⵍⵍⵉ ⴷ ⵉⵣⵔⴼⴰⵏ ⴷ ⵜⴰⵢⵔⵉ	ومنحته حريته وحقوقه والحب
ⵙ ⵜⴷⴰⵍⵉⵡⵉⵏ ⴰⴷ	بهذه الأقسام
ⴰⴷ ⵓⵔⵔⵉⵖ ⵙ ⵉⵡⵏⵏⵉ ⴰⴼⵕⴰⵏⵚⵉⵚ	أعود إلى الإقتباس الفرنسي
ⵏⵙⵔⵙ ⵉⴳⴳⵉ ⵏⵏⵙⵏ ⵢⴰⵜ ⵜⴳⵍⴰⵢⵜ	نضع فوقهما بيضة
ⴰⵢⴰⴷ ⴰ ⵖⴼ ⴷⴰ ⵜⵜⵉⵏⵉⵖ ⵔⴰⴷ ⵙⵔⵙⵖ ⴰⵡⵜⵜⴰⵙ ⴰⵙⵜⵔⴰⵜⵉⵊⵉ ⵉ ⴽⵓ ⴰⵢⵢⵓⵔ	لهذا أقول سأضع هدف إستراتيجي لكل شهر
ⵜⵉⵣⵉ ⴰⵏⵏ ⴷⴰ ⵉⵜⵜⴳⴳⴰ ⵖⵙ ⵉ ⵍⴱⵅⵓⵔ	حينها يكون خاصا للبخور فقط
ⵏⵥⴹⴰⵕ ⴰⴷ ⵏⵉⵍⵉ ⴳ ⵢⴰⵜ ⵜⴳⵎⵎⵉ	فقد نكون بنفس السكن
ⵏⵖ ⵉ ⵓⵙⵉⴼⵙⵓⵙ ⵏ ⵓⴷⵃⴷⵃ	أو للتخفيف من السمنة
ⵙⴳⵉⵙⵏ ⵉⵙⵓⵔⴰⵔⵏ ⵏ ⵡⴰⵣⵣⴰⵥ ⵍⵍⵉ ⵙ ⵜⵜⴷⴷⵓⵏ ⵉⵄⵔⵔⵉⵎⵏ	منها ملاعب القرب التي يذهب إليها الشباب
ⵉⴳⴰ ⵢⴰⵏ ⵓⴼⴳⴰⵏ ⵏⵏ ⴷⴰⵔⵙ ⵉⵍⴷⴷⵉⵏ ⵜⴰⵢⵏⵉⵜ	هو شخص يثير الإنتباه نحوه
ⴰⵛⴽⵓ ⴷⴰ ⴱⴷⴷⴰ ⵉⵜⵜⵉⵍⵉ ⵓⵔⴰⵜⴰⵢ ⴳ ⵡⵓⵜⵛⵉ ⴷⴰⵔ ⵓⴼⴳⴰⵏ	لأنه دائما يكون هناك إضطراب في الأكل عند الشخص
ⵉⵎⴰⵏⵏⴰⵢⵏ ⵏⵏⵖ ⵉⵥⵉⵍⵏ, ⴱⵔⵔⴽⴰⵜ ⵜⵉⴽⴽⵍⵜ ⵢⴰⴹⵏⵉⵏ	مشاهدينا الكرام، مرحبا بكم مرة أخرى
ⵉⵄⵔⵔⵉⵎⵏ ⵓⵔ ⴷⴰ ⵙⵙⵓⵜⵓⵔⵏ ⵜⵓⴽⴽⵉⵙⵉⵏ ⴷ ⵜⵖⵓⵎⵉ ⵀⵍⵍⵉ ⵎⴰⵛⵛ ⴰⵡⴷ ⴰⵙⵎⴽⵍ ⵏ ⵢⵉⵍⴼⵜ	الشباب لا يطلبون القصات والصباغة فقط بل حتى العناية بالبشرة
ⵙⵙⵓⵎⵔⵏ ⴰⵖ ⴰⴷ ⵏⵙⵏⴼⵍⵓⵍ ⴽⵔⴰ ⵏ ⵜⵖⴰⵡⵙⴰ ⵉⵥⵍⵉⵏ ⵙ ⵜⴰⵢⵙⵉ ⵜⴰⵎⴰⵣⵉⵖⵜ	حيث إقترح علينا إبداع شيء مرتبط بالتراث الأمازيغي
ⵎⴰⵛⵛ ⵖⵉⵍⴰ, ⵉⵎⴰⵏⵏⴰⵢⵏ ⵏⵏⵖ ⵉⵥⵉⵍⵏ	لكننا الآن، مشاهدينا الكرام
ⵎⴰ ⵖⴼ ⴷⴰ ⵜⵜⵖⴰⵡⴰⵍⵏⵜ ⵜⵉⵢⵜⵉⵢⵉⵏ ⵏ ⵡⵓⵍ ⵉⵏⵓ ⵓⴳⴳⴰⵔ ⵏ ⵡⵉⵢⵢⴰⴹ ?	لماذا تتسارع نبضات قلبي أكثر من الجميع؟
ⵙⵓⵍ ⴷ ⵡⴰⵎⵓⵏ ⵉⵍⵎⵎⴰ ⵜⵓⵔⵎⵉⵢⵉⵏ	بالإضافة إلى المجتمع ثم التجارب
ⵀⴰⵜ ⴷⴰ ⵜⴻⵜⵜⵙⵙⵏ ⴰⵢⵍⵍⵉ ⵉⵜⵜⵉⵔⵉ ⵓⵔⴳⴰⵣ ⵏⵏⵙ	فإنها تعرف ما يحبه زوجها
ⵜⴰⵏⵎⵎⵉⵔⵜ ⵏⵏⴽ ⴱⴰⵀⵔⴰ ⵎⴰⵙⵙ ⴱⴰⴷⴷⵓ ⵖⴼ ⵡⵓⵎⵍⴰⵏ ⴰⴷ ⵉⵣⴰⵍⴰⵏⵏ	شكرا جزيلا لك سيد بادو على المعلومات القيمة
ⵉⵥⴹⴰⵕ ⴰⴷ ⴼⴽⵖ ⴳ ⵢⵉⴳⵔ ⵓⴳⴳⴰⵔ, ⴰⵛⴽⵓ ⴷⴰ ⵜ ⵜⵜⵉⵔⵉⵖ	ربما أعطي في المجال أكثر لأنني أحببته
ⵓⵔ ⴷⴰ ⵜⴻⵜⵜⴰⵊⵊⴷ ⵉⵍⴼⵜ ⵏ ⵡⵓⴷ ⵏⵏⴽ ⴰⴷ ⵉⵙⵓⵏⴼⵓⵙ	لا تترك المجال لبشرة وجهك لكي تتنفس
ⴰⵢⵍⵍⵉ ⵉⵥⵍⵉⵏ ⴳ ⵓⵎⵣⵔⵓⵢ ⵏ ⵍⵎⵖⵔⵉⴱ	المميز بتاريخ المغرب
ⴷⴰ ⵜⵜ ⵏⵙⵙⵎⵔⴰⵙ ⴽⵓⴷⵏⵏⴰ ⵏⵔⴰ ⴰⴷ ⵓⵙⵙⵉⵡⵉ ⵏⵖ ⴳ ⵜⵥⴰⵍⵍⵉⵜ	نوظفه عندما نرغب بالتأمل أو أثناء الصلاة
ⵢⴰⵀ ⴷⴰ ⴱⴰⵀⵔⴰ ⵜⴻⵜⵜⵣⵔⵉⵔ ⵙ ⵉⵖⴰⵡⴰⵙⵏ ⵏⵏⴰ ⵉⵥⵕⵕⴰ	نعم يؤثر بشكل كبير من خلال البرامج التي يشاهدها
ⵉⵍⵎⵎⴰ ⵉⵇⵇⴰⵏ ⴷ ⴰⴷ ⵜⴻⵜⵜⵓⵙⵏⴼⴰⵍ ⴽⵓ ⴽⵕⴰⴹ ⵢⵉⵔⵏ	أي يجب تغييرها كل ثلاثة أشهر
ⵎⴰⵛⵛ ⵔⴰⴷ ⵉⵏⵉⵖ ⵎⴰⵙ ⵜⵙⴽⵔⴷ ⵉⵎⴽⴰⵏⵏ ⴰⴼⴰⴷ ⴰⴷ ⵜⵙⵎⵎⵔⵜⵍⴷ ⴰⵛⴽⵓ ⵜⴽⵙⵏⴷ ⵉⵢⵉ	بل سأقول أنك تعمدت الإعتذار لأنك تكرهينني
ⵉⴹⵉⵚ ⵏ ⵉⴼⵓⴽⵙⵏ ⵏ ⵜⵓⴷⵔⵜ ⵖⴼ ⵜⵡⵓⵔⵉ ⵏ ⵓⴼⴳⴰⵏ?	تأثير المهارات الحياتية على عمل الإنسان؟
ⴰⴷ ⴽⴰ ⵜⴽⵛⵎ ⵜⵎⵖⴰⵔⵜ ⵜⵙⵙⵏⵜⵉ ⵜⵉⵡⵓⵔⵉⵡⵉⵏ ⵏ ⵜⴳⵎⵎⵉ	فور دخول المرأة تشرع في أعمال البيت
ⵉⵍⵎⵎⴰ ⵉⴳ ⵜ ⴳ ⵢⴰⵏ ⵓⴳⵣⵣⵓⵎ ⵏ ⵓⵖⵔⴰⴱ	نعم يضعه في جزء من الحائط فقط
ⵖⴼ ⵓⴳⵏⵓⵙ, ⴰⴼⵔⵓⵅ ⵏⵖ ⵜⴰⴼⵔⵓⵅⵜ	حسب الجنس ولد أو بنت
ⴷ ⵓⵢⴰⴷ ⴰ ⵉⵙⵔⵓⴳⵏ ⵜⴰⴳⵍⴽⴰⵣⵜ	وهذا ما يسبب الغلكزة
ⵎⴰⵛⴰ ⴳⴰⵏⵜ ⵜⵓⴳⵜⵜ ⵏ ⵜⴱⵔⴰⵜⵉⵏ ⴷⴰⵔⵙⵏⵜ ⵜⵓⵇⵇⵏⴰ ⴷ ⵜⵎⵖⴰⵔⵜ ⴷ ⵡⴰⴷⴷⴰⴷⵏ ⵏⵏⵙ	بل هي رسائل عديدة لها إرتباط بالمرأة وظروفها
ⴰⵔ ⴱⴷⴷⴰ ⵜⵜⵉⵏⵉⵖ, ⴽⵓⴷⵏⵏⴰ ⵉⴽⵛⵎ ⵉⵡⵉⴽ ⵙ ⵜⴰⴷⴷⴰⵔⵜ	دائما أقول، حين يدخل إبنك إلى البيت
ⴷ ⵓⵔ ⵜⵜ ⵉⵡⵉⵏⵜ ⵉⵙ ⴷⴰ ⴰⵙ ⵢⴰⴽⴽⴰ ⵓⵎⵜⵛⵓ ⵜⴰⴼⴰⵙⴰ ⵢⵓⴷⴰⵏ	ولاتهتم إن كان الأكل يمنحه الطاقة الكافية
ⵙⴳ ⵢⴰⵏ ⵓⵣⵎⵣ ⴽⴽⵉⵖ ⵜⵜ ⵉⵏⵏ ⴰⵔ ⵙⵇⵙⴰⵖ ⵎⴰⵅⵅ ⵓⵔ ⵍⵍⵉⵏ ⵉⵙⴷⴷⵉⵜⵏ ⴳ ⵓⵏⵣⵡⴰⵢ	منذ مدة كنت أتساءل لما لا توجد مسلسلات في الإذاعة
ⵉⵣⵣⵏⵣ ⵜⵜ ⵓⵔⴳⴰⵣ ⴳ ⵉⴳⴰⴷⴰⵣⵏ	يبيعها الزوج في الأسواق المحلية
ⵉⴳ ⵉⵍⵍⴰ ⴳ ⴽⵔⴰ ⵏ ⵡⴰⴷⴷⴰⴷ, ⵎⴰⵏⵎⴽ ⵜ ⵉⵙⵙⴼⵔⵓ?	إذا تعرض لموقف كيف يفسره؟
ⴰⵛⴽⵓ ⴷⴰ ⵍⵙⵙⴰⵏⵜ ⵉⴱⵓⵔⴽⵙⵏ ⵉⴽⵕⵕⵓⵥⵏ	لكونهم يرتدين أحدية ضيقة
ⴰⴷ ⵏⵎⵢⴰⵙⵙⴰⵏ ⵖⴼ ⵜⵎⴰⵎⴽⵜ ⵏ ⵓⵙⵏⵎⴰⵍⴰ ⵏ ⵜⴷⴰⴱⵓⵜⵉⵏ ⴷ ⵜⵜⵉⵇⵏⵉⵢⵉⵏ ⵏ ⵓⵙⵏⴱⴳⵉ	لنتعرف على كيفية ترتيب الموائد وتقنيات الإستضافة
ⵖⵉⵍⴰ ⵔⴰⴷ ⵙⴱⵔⵔⴽⵖ ⴰⵙⵍⵎⴰⴷ ⵄⴰⴱⴷⵓⵍⵍⴰⵀ ⴱⴰⴷⵓⴷ	الآن سأرحب بالأستاذ عبد الله بادود
ⴰⵔ ⵏⵙⴰⵡⴰⵍ ⴰⵡⴷ ⵖⴼ ⵜⵔⴰⵔⵉⵜ	نتحدث كذلك عن المردودية
ⵜⴰⴷⵓⵙⵉ ⵜⴰⵏⵉⵎⴰⵏⵜ	الصحة النفسية
ⴰⴼⴰⴷ ⴰⴷ ⵏⵏ ⵏⴳ ⵜⵉⵍⵉⵏⵜⵉⵜⵉⵏ ⵣⴷⴷⵉⴳⵏⵜ, ⵏⴰⵔⵢ ⵜⴰⵏⴼⵔⵓⵜ ⵏ ⵡⴰⵍⵍⵏ ⵏⵏⵖ	لكي نضع العدسات نظيفة، و نحافظ على سلامة أعيننا
ⴷⴰ ⵜⵔⵏⵏⵓⴷ ⵉⴽⵯⵍⴰⵏ ⴳ ⵓⵏⵛⵜ ⵏ ⵜⴰⵏⵏⴰⵢⵜ ⵏⵏⵎ	تضيف الألوان بحسب رويتك
ⵎⴰⵙ ⴷⴰ ⵉⵙⴽⴰⵔ ⵜⵉⵎⵙⴽⴰⵔ ⵜⵓⴽⵎⵉⴹⵉⵏ	أنه يمارس السلوكيات العنيفة
ⵏⴼⴼⵉ ⴳⵉⵙ ⵉⵎⵉⴽⴽ ⵏ ⵡⴰⵎⴰⵏ	ونسكب فيها القليل من الماء
ⵏⴰⴷⵔ ⴼⵍⵍⴰⵙ	ونضغط عليها
ⴷ ⴰⴷ ⵉⵍⵎⴷ ⴰⵥⵉⴹⵕ	و أن يتعلم الصبر
ⵉⵇⵇⴰⵏ ⴷ ⴰⴷ ⵏⴽⴽⵙ ⵜⴰⵙⵙⴰⵙⵜ	يجب القضاء على التوتر
ⵏⴳ ⵏⵏ ⴰⴽⵯⴼⴰⵢ	ونضيف الحليب
ⵢⴰⵀ, ⴷ ⵏⵏⵉⵖ ⴰⵎ ⵎⴰⵙ ⵉⴳⴰ ⴰⵖⴰⵡⴰⵙ ⴳ ⵓⵙⵎⵓⵜⵜⴳ	نعم، وقد أخبرتك أنه برنامج قيد التأهيل
ⵙ ⵜⵉⴷⵜ ⴰⵔ ⵜⵜⵉⵔⵉⵖ ⴰⴷ ⵙⵍⵍⴰⵖ ⵉ ⵓⴳⵕⴹ ⵏⵏⴽ ⴳ ⵎⵏⵏⴰⵡ ⵉⵡⵔⵉⴽⵏ	صراحة أحب أن أسمع صوتك في شخصيات مختلفة
ⴷⴰ ⵏⵙⴰⵡⴰⵍ ⵖⴼ ⵎⴰ ⵉⴷⴷⴰⵏ ⴷ ⵎⴰⵢⴷ ⴷ ⵢⵓⵔⵔⵉⵏ	نتحدث عمّن ذهب ومن عاد
ⴽⵓ ⵜⴰⵣⵣⵓⵍⵜ ⴷⴰⵔⵙ ⵉⵍⵓⴳⴰⵏⵏ ⵏⵏⵙ ⴷ ⵜⵎⵙⵙⵏⵉⵡⵉⵏ ⵙⵉⵙ ⵉⵥⵍⵉⵏ	كل حرفة لها قواعدها والمعارف الخاصة بها
ⵍⵍⵉ ⴳ ⴷⴰ ⵜⵏ ⵉⵏⵏ ⵍⴷⴷⵉⵏ ⵙ ⵓⵎⵙⴰⵡⴰⵍ ⴰⴽⵓⵢⴰⵙⵙ ⴷ ⵓⵙⵏⵏⴼⴽⴰ ⵏ ⵡⵓⴼⴼⵉⵔⵏ	اذ يستدرج عبر الحديث اليومي وتبادل الأسرار
ⵎⴰⵏⵎⴽ ⵏⵙⵎⵓⵜⵜⴳ ⵜⴰⴽⵉⴽⵜ ⵙ ⵛⵛⴽⵯⵍⴰⵟ	كيفية إعداد الكعكة بالشوكولاتة
ⴷ ⵜⴼⵔⵅⵉⵏ ⵏⵏⴰ ⵉⴼⵍⵏ ⵜⵉⵖⵔⵉ	للفتيات المنقطعات عن الدراسة
ⴰⵛⴽⵓ ⴷⴰ ⵢⴰⴽⴽⴰ ⵉⴱⵕⵓⵟⵉⵏⵏ ⵏⵏⴰ ⵉⵣⵣⵉⴳⵉⵣⵏ ⴳ ⵜⴼⴽⴽⴰ ⵏⵏⵖ	لأنه يوفر البروتينات التي تسير في جسمنا
ⵏⴽⴽⵉ ⵓⵔ ⵥⴹⵉⵕⵖ ⴰⴷ ⵙⵓⵜⵜⵓⵖ ⴰⵡⵜⴰⵢ ⵉⴳⴰ ⵉ ⵢⵉⵡⵍ	شخصيا لا يمكنني تحديد العمر المناسب للزواج
ⵢⴰⵀ, ⵉⴽⵛⵎ ⵓⵍⴰ ⵏⵜⵜⴰ ⴳ ..	نعم، يندرج أيضا ضمن التفاؤل
ⴳ ⵜⵎⵀⵍⵜ ⴷⴰ ⵜⵜ ⵏⵜⵜⴽⴽⵙ ⴳ ⵡⴰⴷⴷⴰⴷⵏ ⴰⴽⴽⵯ	عند العملية نستأصلها في جميع الحالات
ⴰⴼⴰⴷ ⴰⴷ ⵏⵏⴱⴹ ⴳ ⵜⴽⵚⵚⴰⴹ ⵏⵏⵖ ⵉⵍⵍⴰ ⵣⵡⴰⵔ ⴼⵍⵍⴰⵖ ⴰⴷ ⵏⵙⵙⵉⴽⵣ ⵎⴰⵙ ⵖⵓⵔⵏⵖ ⵜⵉⴽⵚⵚⴰⴹ ⵜⵉⵔⴳⴰⵎⴰⵏⵉⵏ	كي نتحكم في خوفنا علينا أولا أن نعترف بأننا مصابون بخوف غير طبيعي
ⵉⵇⵇⴰⵏ ⴷ ⴰⴷ ⴼⵜⵓⵖ ⴷⴰⵔ ⵜⵔⵓⴱⴱⴰ ⵏ ⵓⵃⵡⴰⵛ	لابد أن أذهب لدى فرق أحواش
ⴷ ⵜⵉⵣⵉ ⴰⵏⵏ ⵔⴰⴷ ⵏⵉⵜ ⵜⴰⴼⴷ ⴰⵙⵍⵎⴰⴷ	وعندئذ فعلا ستجد الأستاذ
ⵍⵍⵉ ⵉⵙⵙⵓⵎⵓⵎⵏ ⴰⴽⴰⵍⵙⵉⵢⵓⵎ ⵙⴳ ⵉⵖⵙⴰⵏ ⴰⴼⴰⴷ ⴰⴷ ⵉⵙⵎⵢⴰⵙ ⵉⴷⴰⵎⵎⵏ ⵏⵏⵙ	التي تمتص الكالسيوم من العظام لتوازن دمه
ⵍⵍⵉ ⵉⵏⵇⵇⴰⵏ ⵜⵉⵖⵔⴰⵙⵉⵏ ⵏ ⵢⵉⵍⵎ	مما يتسبب في موت خلايا الجلد
ⵓⵔ ⴷⴰ ⵉⵙⵡⵉⵏⴳⵉⵎ ⵙ ⵜⴳⵔⵔⴰⵡⵜ ⵏⵏⵙ ⵉⵍⵎⵎⴰ ⵜⵍⵍⴰ ⵜⵎⵙⵜⴳⴳⴰⵔⵜ ⵉⵎⵇⵇⵓⵔⵏ ⴽⵉⴳⴰⵏ ⴷⴰⵔ ⵓⵙⵍⵎⴰⴷ	لا يفكر بعقله لذا تقع مسؤولية كبير جدا على عاتق الأستاذ
ⵓⵔ ⵜⴷⴳⴳⵉ ⵎⴰⵙ ⴷ ⵢⵉⵡⵉⵙ ⴷⴰⵔⵙ ⴽⵔⴰ ⵏ ⵓⵄⴹⵓⴱⵓ	لا تتقبل أن إبنها يعاني من إعاقة معينة
ⵎⴰⵛⵛ ⵖⴼ ⵜⵓⵎⴰⵙⵜ ⵏ ⵜⵡⵡⵓⵔⴽⴰ ⵏⵏⵙ	بل على طبيعة شخصيته
ⴰⵛⴽⵓ ⴽⵓⴷⵏⵏⴰ ⵉⴼⴼⵖ ⵓⴼⴳⴰⵏ ⵙⴳ ⵜⵡⵓⵔⵉ ⵉⵇⵇⴰⵏ ⴷ ⴰⴷ ⵉⵏⵢⴰⵍⴽⴰⵎ ⴰⴽⴷ	فحين الخروج من العمل يطالب بالتواصل مع
ⴰⵎⵓⵢ ⵉ ⵕⴱⴱⵉ ⴷⴰⵔⵏⵖ ⴰⵎⵎⴰⵙ ⴳ ⵜⵎⴷⵉⵏⵜ ⵏ ⴷⴷⵛⴰⵢⵔⴰ	الحمد لله لدينا مركز في مدينة الدشيرة
ⴷ ⴰⵡⴷ ⵉⵎⵓⴹⴰⵏ ⵏ ⵓⴽⴰⵏⵚⵉⵕ	وكذلك مرضى السرطان
ⵉⵙⵙⵓⵙⵎ ⵉⵢⵉ ⴰⴷ ⴷⵉⵜⵓⵏ ⵉⵍⵉⵖ ⴰⵙⵙ ⴰⴷ	سعيد بتواجدي معكم اليوم
ⵉⵎⴽⵍⵍⵉ ⵜⵥⵕⵕⴰⵎ ⴽⵔⵉⵎⴰ ⵜⵓⵔⵔⵉ ⵜⵎⵓⵜⵜⴳ	كما تلاحظون الكريمة أصبحت جاهزة
ⵉⴳ ⵜⵍⵍⴰ ⴳ ⵉⵎⴷⴷⵓⴽⴽⴰⵍ ⵏⵏⴽ ⵏⵖ ⵡⵉⵍⵍⵉ ⵜⵙⵙⵏⴷ	إذا كانت ضمن دائرة أصدقائك أو معارفك
ⵎⴰⵛⵛ ⵉⴳ ⴷ ⵜⵙⴷⵓⵇⵇⵔ ⵜⵏⴰⵔⴰⴳⵜ ⴷ ⵏⴽⴽⵉ ⵙⴰⵍⴰⵖ	ولكن إذا طرقت الجارة وأنا مشغولة
ⵉⵥⴹⴰⵕ ⴰⴷ ⴽ ⵉⴷ ⵉⵇⵇⴰⵏ ⴰⴷ ⵜⵔⵣⵓⴷ, ⵜⵖⵔⴷ, ⴷ ⴰⴷ ⵜⵣⵎⵎⴻⵎⴷ ⴳ ⵜⵙⴷⴰⵡⵉⵜ	ربما عليك البحث والدراسة، والتسجيل في جامعة
ⴰⴷ ⵙⵓⵍ ⴼⴼⵖⵏ ⴳ ⵜⴰⴷⴰⵡⵜ	تظهر في ظهره بعد حين
ⴰⵛⴽⵓ ⴰⴼⴳⴰⵏ ⵉⵏⵏⴰ ⴰⴽ ⴰⵡⴰⵍ ⴽ ⵉⵣⵣⵉⵡⵣⵏ	لأن الشخص قال لك كلام أزعجك
ⵓⵔ ⴷ ⵉⵙ ⵙⵉⵙⵏⵜ ⵓⵔ ⵏⵥⵉⵖ	ليس أنني غير مقتنع بها
ⵖⵉⵍⴰ ⵍⵍⵉⴳ ⵏⵙⵎⵓⵜⵜⴳ ⵉⵛⴰⴽⴰⵏ, ⴰⴷ ⵏⵙⵎⵓⵜⵜⴳ ⵜⴰⴼⵍⵍⵓⵏⵜ	الآن عندما حظرنا الخضار، نحضر مقلاة
ⴰⵛⴽⵓ ⵜⴰⵎⵖⴰⵔⵜ ⵜⴰⵎⴰⵣⵉⵖⵜ ⵜⴷⵓⵙ ⴱⴷⴷⴰ	لأن المرأة الأمازيغية دائمًا قوية
ⵉⵙ ⵓⵔ ⴷⴰ ⵢⴰⴽⴽⴰ ⴰⵏⴳⴰⵥ?	ألا ينتج عنها ألم؟
ⵛⵛⴽⵯⵍⴰⵟ	شوكولاتة
ⵉⵍⵎⵎⴰ ⴰⴷ ⵏⴹⴼⵕ ⴰⵏⴳⵔⴰⵡ ⴰⵎⵙⴰⴷⵓⵔ	أي اتباع الحمية
ⴰⵛⴽⵓ ⵡⴰⵍⵍⵉ ⵉⵜⵜⵓⵙⵙⵍⴰⵢⵏ ⵉⵥⵍⵉ ⵙ ⵡⵓⵜⵛⵉ	لأن الذي حُمص مخصص للأكل
ⵉⵍⵍⴰ ⵎⴰⵢⴷ ⵜⴻⵜⵜⴰⵖ ⵜⵖⵓⴼⵜ ⵏ ⵡⵓⵏⴼⵓⵙ	هناك من يصاب بضيق التنفس
ⵏⵔⵏⵓ ⵉⵎⵉⴽⴽ ⵏ ⵓⴳⴳⵯⵔⵏ	نضيف بعض الدقيق
ⵜⴰⵍⴼⴷⴰⵏⵜ ⵜⴳⴰ ⵢⴰⵏ ⵓⴼⴷⴷⵓⴷⵔ ⵉⵜⵜⴰⵖⵏ ⵜⵡⵔⵎⵉⵏ	النقرس هو إلتهاب يصيب المفاصل
ⵃⴰⵙⵏⴰ ⵜⴰⵎⵙⵖⵉⵡⵙⵜ ⵏ ⵜⵎⵍⵙⴰ	حسناء مصممة أزياء
ⵣⵓⵏ ⴷ ⵡⵉⵍⵍⵉ ⴷⴰⵔ ⵉⵡⴽⴽⴰⵜⵏ ⵏ ⵓⴷⵉⵙ	كمن لديهم ديدان البطن
ⵏⵥⵥⵍⵎ ⵍⴽⵉⵡⵉ	نقشر الكيوي
ⵏⴳ ⵏⵏ ⴰⵣⴰⵜⵉⵎ	نضع الزيت
ⴰⵢⵢⵓⵣ ⵏⵏⴽ ⴰ ⵛⵛⵉⴼⴼ ⵃⵎⴰⴷ ⵖⴼ ⵓⴹⴱⵚⵉⵍ ⴰⴷ ⵉⵥⵉⵍⵏ	نحييك الشيف حماد على هذا الطبق الرائع
ⵖⵉⵍⴰ ⴰⴷ ⵏⴼⵜⵓ ⴷⴰⵔ ⵜⵓⴷⴰ ⴷ ⵛⵛⴰⴼ ⵃⵎⴰⴷ	الآن نلتحق بتودا والشاف حماد
ⵖⵉⵍⴰ ⴰⴷ ⵜⵏ ⴰⴽⴽⵯ ⵏⵙⵎⵔⴽⵙ	الآن نقوم بخلط الكل
ⴰⵙⵙ ⴰⴷ ⵔⴰⴷ ⵏⵙⴰⵡⵍ ⵖⴼ ⵓⵙⵏⴼⵍ ⴰⵏⵉⵎⴰⵏ	اليوم سنتكلم عن التغيير الذاتي
ⴰⵛⴽⵓ ⴰⵡⴷ ⵜⵉⵍⵉⴼⵉⵣⵢⵓⵏ	لأن التلفاز أيضا
ⵉⵙⵎⵣⴰⵣⴰⵍⵏ ⵙ ⵜⵍⵖⴰ ⴰⴷ ⴷⴰ ⴳⵉⵙ ⵜⵜⴰⵡⵙⵏ ⵎⵏⵏⴰⵡ ⵉⵎⵙⴽⴰⵔⵏ	المقارنات بهذه الصيغة تساهم فيها عدة عوامل
ⵉⵇⵇⴰⵏ ⴷ ⴰⴷ ⵜⵏ ⵉⵙⵏⵎⴰⵍⴰ ⴳ ⵓⵏⵛⵜ ⵏ ⵉⵙⵉⵣⵡⵉⵔⵏ	يجب أن يرتبها حسب الأولوية
ⴱⵔⵔⴽⴰⵜ ⴳ ⵜⵙⴷⴷⵉⵜ ⵜⴰⵎⴰⵢⵏⵓⵜ ⵏ ⵓⵖⴰⵡⴰⵙ ⵏⵏⵓⵏ ⵜⴰⴼⴰⵜ	مرحبا بكم في حلقة جديدة من برنامج تافات
ⵉⵍⵎⵎⴰ ⴱⴱⵉⵖ ⵜ	بعد ذلك قمت بتقطيعه
ⵜⴰⴷ ⵜⴽⵜⵓⵔ ⵙ ⵉⵕⵛⴰⵎⵏ	هذه ممتلئة بالزخارف
ⵖⴰⵎⴰⵢⴰⵜ ⴷⵉⵜⵉ ⴳ ⵜⴳⵟⵟⵓⵎⵜ ⵏ ⵓⵖⵓⴷⵓ	ابقوا معي في فقرة الجمال
ⵎⴰⵏⵎⴽ ⵏⵥⴹⴰⵕ ⴰⴷ ⵏⵙⵙⵏ ⵜⴰⵡⴰⵖⵉⵜ ⵙ ⵜⴼⴰⴼⵜ ⵏ ⵎⵓⵔⵜⵓⵏ	كيف يمكن التعرف على الإصابة بورم مورتون
ⵉⵙ ⵜⵙⵙⵏⴷ ⵎⴰ ⵉⴳⴰ ⵜⴰⴼⵍⵙⵉⵎⴰⵏⵜ ⴰ ⵜⴰⵙⵍⵎⴰⴷⵜ ⴼⴰⵟⵉⵎⴰ?	هل تعرفين ما هي الثقة في النفس أستاذة فاطمة
ⵙⴳ ⵉⵔⵎⵓⴳⵏ ⵉⵙⵉⵏⴰⵏⵏ ⵏ ⵓⴷⵃⴷⵃ ⵜⴳⴰ ⵜ ⵜⵖⵓⴼⵜ ⵏ ⵡⵓⵏⴼⵓⵙ	من بين المضاعفات الجانبية للسمنة هي ضيق التنفس
ⵏⵔⵏⵓ ⴰⵡⴷ ⵙⵙⵓⵙ ⵏ ⴽⵉⵜⵛⵓⴱ	بالإضافة إلى صلصة الكيتشوب
ⵏⵎⵎⴰⵇⵇⴰⵔ ⴳ ⵓⵙⵏⴽⴷ ⵉⴳ ⵜ ⵉⵏⵏⴰ ⵕⴱⴱⵉ	نلتقي في التقديم إن شاء الله
ⵉⵎⴰⵙⵙⵏ ⵍⵍⵉ ⵙ ⵢⵓⴼⴰ	الوسائل التي يستطيع بها
ⴷⴰ ⵏⵏ ⴷⴰⵔⵙ ⵜⵜⴰⵛⴽⵏ ⵓⵎⵏⵉⴳⵏ	ينجذب إليه الإيجابيون
ⵙ ⵓⵎⴷⵢⴰ ⵡⵉⵍⵍⵉ ⴷⵉⵜⵉ ⵉⴳⴰⴷⴷⴰⵏ	مثلا من هم بنفس سني
ⴷ ⵉⴼⵉⵜⴰⵎⵉⵏⵏ D ⴷ E	والفيتامينات D وE
ⴳ ⵓⵏⵛⵜ ⵏ ⵓⵎⴰⴹⵓⵏ	حسب حجم المريض
ⵎⵏⵛⴽ ⵏ ⵡⴰⴽⵓⴷ ⴰⵢⴷ ⴰⵎ ⵜⴻⵜⵜⴰⵡⵉ ⵜⵥⴹⵉ ⵏ ⵓⵢⴰⴷ?	كم من الوقت تتطلب منك حياكة هذا ؟
ⴷⴰⵔⵙ ⵜⵓⴳⵜⵜ ⵏ ⵉⴱⵖⵓⵔⵏ	لها فوائد عديدة
ⵣⵓⵏ ⴷ ⴰⴼⴳⴰⵏ ⴰⵏⴰⵔⵊⵉⵙⵉ ⵏⵏⴰ ⵉⵥⵕⵕⴰⵏ ⵉⵖⴼ ⵏⵏⵙ ⵉⴳⴰ ⴰⵎⵎⴰⵙ ⵏ ⵓⵎⵖⵔⴰⴷ	كالشخص النرجسي الذي يرى نفسه مركزا للكون
ⴽⵔⴰ ⵜⵥⴹⴰⵕ ⴰⴷ ⴰⵙⵏ ⵜⵙⴽⵔ ⵜⴰⴼⵓⴽⵜ ⵜⴰⴽⵎⵎⴰⵡⵜ ⴳ ⵢⵉⵖⴼ	البعض قد تخلق لهم الشمس ضررا في الرأس
ⵖⵉⴷ ⵜⵍⵍⴰ ⵜⵎⵇⵔⴰⵏⵜ ⴷ ⵜⵎⵥⵢⴰⵏⵜ	هنا توجد الكبيرة والصغيرة
ⵎⴰⵛⴰ ⴰⵢⵍⵍⵉ ⵉⵥⵉⵍⵏ ⵉⴳⴰ ⵜ ⴰⴷ ⵜ ⵜⴰⵡⵉⴷ ⵙ ⵜⴷⴰⵍⴰ ⵢⴰⴹⵏⵉⵏ ⴷ ⵉⵏⵍⵎⴰⴷⵏ ⵢⴰⴹⵏⵉⵏ	لكن الأجمل أن تأخذه إلى قاعة أخرى وتلاميذ آخرين
ⵉⵎⴳⵍⵙⴽⴰⵏⵏ ⵉⴽⵓⴷⴰⵏⵏ	هناك موانع مؤقتة
ⴷ ⵉⵙ ⵔⴰⴷ ⵉⵜⵜⵓⵔⵎⴰⵙ ⵡⴰⵡⴰⵍ ⵉⵏⵓ ⵎⵍⵉⵃ	و هل سيفهم كلامي بشكل صحيح
ⵣⵓⵏ ⴷ ⵜⵓⵜⵍⴰⵢⵜ ⵜⴰⵎⴰⵣⵉⵖⵜ ⴷ ⵜⵄⵕⴰⴱⵜ ⴷ ⵜⴼⵕⴰⵏⵙⵉⵙⵜ	كاللغة الأمازيغية أو العربية أو الفرنسية
ⵉⵍⵎⵎⴰ ⵏⵜⵜⵏⵉ ⵎⵛⴰⵛⴽⴰⵏ ⴷ ⵙⴳ ⵜⵣⵡⵉⵔⵉ ⵖⴼ ⵜⵉⵣⵉ ⵏ ⵚⴹⵉⵚ ⵢⵉⵔⵏ	أي أنهما إتفقا منذ البداية على مدة ستة أشهر
ⵓⵔ ⵉⵥⴹⵉⵕ ⴰⴷ ⵉⵏⵏⵓⵎⵎⵙ ⴳ ⵢⴰⵜ ⵜⵉⵣⵉ	غير قادر على التركيز لمدة معينة
ⵜⴰⵎⵥⵢⴰⵏⵜ ⴰⴷ	هذه الصغيرة
ⴷ ⵥⴹⴰⵕⵏ ⴰⴷ ⵙⴽⵔⵏ ⵜⴰⴳⵔⵓⵎⵎⴰ ⵏ ⵜⵖⴰⵡⵙⵉⵡⵉⵏ	وبإمكانهم القيام بمجموعة من الأشياء
ⵔⴰⴷ ⴰⵙⵔⵖ ⴰⴼⵛⴽⵓ	سأحتاج لإناء
ⴰⵢⵍⵍⵉ ⵉⵙⵔⵓⴳⵏ ⴰⵏⵓⵙⵔⵓ ⵏ ⵓⴼⴰⵔⵙ ⵏⵏⵙ	ما يؤدي إلى إنخفاض إنتاجه
ⴷ ⵖⵉⵍⴰ ⵔⴰⴷ ⵙⵙⵅⵙⵉⵖ ⴰⴼⴰ	والآن سأطفئ النار
ⵉⵇⵇⴰⵏ ⴷ ⴰⴷ ⵜⵙⵏⵉⵎⵎⵔⴷ ⵜⵉⵏⵓⴼⴰ ⴷ ⵏⵜⵜⴰ ⴰⵢⴷ ⵉⵜⵜⴳⴳⴰⵏ ⴰⵙⵔⴰⴳ ⴰⴷ ⴷ ⴰⵛⴽⵏⵜ ⵜⵖⴰⵡⵙⵉⵡⵉⵏ ⵢⴰⴹⵏⵉⵏ	عليك بشكر النعم وهو مايكون سببا في قدوم أخرى
ⵜⵉⵎⵖⴰⵔⵉⵏ ⴷⴰ ⴷⴰⵔⵙⵏⵜ ⵉⵜⵜⵉⵍⵉ ⴹⴰⵕⴰⵜ ⵜⴰⵔⵡⴰ	فالنساء يكون لديهن بعد الولادة
ⵜⴰⵏⵎⵎⵉⵔⵜ ⴰ ⴼⴰⵟⵉⵎⴰ	شكرا لك فاطمة
ⵢⴰⵀ ⵡⴰⴷ ⴰ ⵉⴳⴰⵏ ⴰⵡⵜⵜⴰⵙ ⴰⵎⵣⵡⴰⵔⵓ	طبعًا هذا هو الهدف الأول
ⵉⵓⵍⴰ ⵎⴰ ⵉⵜⵜⴳⴳⴰⵏ ⵢⴰⵏ ⵓⵍⵡⵡⴰⵜ ⵖⴼ ⵓⴼⵓⵙ ⵏⵏⵙ ⴷ ⴷⴰ ⵜ ⵙⵉⵙ ⵉⴽⴽⴰⵜ ⴳ ⵜⵉⵣⵉ ⵏ ⵜⴰⵙⵙⴰⵙⵜ	هناك من يضع مطاطا على يده ويضربها به لحظة التوتر
ⴽⵓⴷⵏⵏⴰ ⵉⵎⵓⵔⵙ ⴳ ⵜⴳⵉⵔⴰ ⵏ ⵓⵙⴳⴳⵯⴰⵙ ⴰⵏⵎⵍⴰⵏ	فعند نجاحه في نهاية السنة الدراسية
ⵖⴼ ⵡⴰⴹⵓ ⵏ ⵜⵣⵡⵉⵡⵖⵜ	من رائحة الورد
ⴷ ⴽⵓⴷⵏⵏⴰ ⵉⵙⵍⵍⴰ ⵉ ⵓⵢⴰⵏⵏ ⵉⵥⵕ ⵜ, ⴷⴰ ⵜ ⵉⵜⵜⵃⴹⵓ ⴳ ⵓⴳⵏⵙⵓ ⵏⵏⵙ	وحين يسمع ذلك ويراه يخزنه بداخله
ⵏⵖ ⵜⵉⵎⵙⵎⵓⵏⵉⵏ ⵍⵍⵉ ⵉⵙⴽⴰⵔⵏ ⵉⵔⵎⵓⴷⵏ ⵏ ⵓⵎⵓⵙⵙⵓ	أو الجمعيات التي تقوم بالأنشطة الحركية
ⵉⵣⴰⵍⵏ ⴼⵓⵍⴽⵉⵏ ⴱⴰⵀⵔⴰ ⵉⵎⴽⵍⵍⵉ ⵢⴰⴷ ⵏⴻⵏⵏⴰ	القيم جميلة جدًا كما سبق وتحدثنا
ⴳ ⵜⵃⴰⵏⵓⵜ ⵏ ⵎⴰⵙⵍⵢⴰ	في محل ماسليا
ⴰⴷ ⵜⴼⴽⴷ ⵉ ⵜⴼⴽⴽⴰ ⴰⵢⵍⵍⵉ ⵜⵜ ⵉⵙⵙⴱⵖⴰⵔⵏ	أن تمنح الذات ما ينفعها
ⵉⵍⵎⵎⴰ ⵜⴰⵣⵉⴳⵣⵜ ⵏ ⵓⵙⵏⴼⵍⵉ ⴷ ⵓⵙⴼⴰⵍⴽⵉ	إذن عملية التطوير والتحسين
ⵖⴼ ⴰⴷ ⵉⵙⵎⵎⴽⵜⵉ ⴷ ⵉⵎⴷⴷⵓⴽⴽⴰⵍ ⵏⵏⵙ	على أن يراجع مع أصدقائه
ⵏⵙⵏⵓⴹⵓ ⵜⵜ ⴰⵔ ⵜⵓⵥⵥⵓⵎⵜ	نثنيها إلى غاية المنتصف
ⵎⴰⵛⵛ ⵍⵍⴰⵏ ⵉⵏⴳⴰⵥⵏ ⴷⴰ ⵉⵜⵜⴳⴳⵯⵣ ⵓⴽⵕⴰⵥ ⵏⵏⵙⵏ ⴳ ⵢⵉⴹ ⴳ ⵢⵉⴹⵚ	غير أن هناك آلالام تنخض حدتها في الليل عند النوم
ⴰⵙⵎⵣⴰⵣⴰⵍ ⴰⴷ ⴷⴰⵔⵙ ⵉⴹⵉⵚⵏ ⵖⴼ ⵜⵏⵉⵎⴰⵏⵜ ⵏ ⵓⴼⴳⴰⵏ?	هذه المقارنة لها آثار على نفسية الإنسان؟
ⴷ ⵎⴰⵢⴷ ⵢⵓⴳⵔⵏ ⴰⵢⴰⴷ ⴰⴽⴽⵯ ⵜⴳⴰ ⵜ ⵜⴽⵕⴹⵉ ⵙ ⵜⵎⴰⵜⴰⵔⵜ	وأخطر من كل هذا هو العنف الرمزي
ⴰⵛⴽⵓ ⵕⴱⴱⵉ ⵉⴼⴽⴰ ⵉ ⴽⵓ ⵢⴰⵏ ⴳⵉⵜⵏⵖ ⵜⵉⵔⴳⵉⵜ ⵏⵏⵙ	لأن الله وهب لكل منا رزقه
ⵜⴰⵎⵇⵔⴰⵏⵜ ⴷⴰ ⵜⴼⵔⵔⵓ ⵜⵉⵎⵇⵕⴰⴹ ⵉ ⵜⴰⵍⵍⵉ ⴷ ⵜⵎⵎⵓⵖⵏⴷ	الكبرى تدفع المبالغ للتي تعاقدت معها
ⴰⵙⵡⵓⴷⴷⵓ ⵏ ⵜⵓⴼⵔⴰⵢⵉⵏ ⵢⵓⵙⵔ ⵜⵉⵣⵉ ⵉⵖⵣⵣⵉⴼⵏ	فتدبير المشاعر يحتاج لمدة طويلة
ⵏⴰⵊⵊ ⵉⵛⴰⴽⴰⵏ ⴰⴷ ⵏⵡⵓⵏ ⵉⵎⵉⴽⴽ	نترك الخضر تطهى قليلا
ⵉⵥⴹⴰⵕ ⴰⴷ ⵢⵓⵔⵔⵉ ⵙ ⵓⵔⵎⵓⴷ ⵏⵏⵙ ⵙ ⵜⵖⴰⵔⴰⵙⵜ ⵜⴰⴳⴰⵎⴰⵏⵜ	بإمكانه أن يعود لنشاطه الرياضي بشكل طبيعي
ⴷⴰ ⵜⴻⵜⵜⴰⴼⴰⴷ ⵉⵖⴼ ⵏⵏⴽ ⴷⴰ ⵜⵛⵜⵜⴰⴷ ⵎⴰ ⵉⴳⴳⵓⵜⵏ ⴱⵍⴰ ⴰⴼⵔⴰⴽ	تجد نفسك تأكل كميات كبيرة بلا وعي
ⴰⴷ ⵉⵙⵙⵏ ⵎⴰⵏⴰⴳⵓ ⴷ ⵉⵇⵇⴰⵏ ⴰⴷ ⵉⵙⴰⵡⵍ ⴷ ⵎⴰⵏⴰⴳⵓ ⴷ ⵉⵇⵇⴰⵏ ⴰⴷ ⵉⴼⵙⵙ	أن يعرف متى يجب أن يتحدث و متى يجب أن يصمت
ⵉⵎⵓⴹⴰⵏ ⵙ ⵡⴰⵟⵟⴰⵏⵏ ⵓⵔ ⵉⵜⵜⵊⵊⵉⵏ ⴷⴰ ⵜⵜⴽⴽⴰⵏ ⴰⴽⵓⴷ ⵉⵖⵣⵣⵉⴼⵏ	المصابون بأمراض مزمنة يستغرقون وقتا أطول
ⵉⵎⴰ ⵉⵙⵍⴷⴰⵢⵏ ⵉⴳⵏⵙⴰⵏⵏ ⵏ ⵜⵙⵖⴰⵍⵉⵏ ⵏ ⵜⵙⴼⵕⴰⴹ ⵏⵖ ⵉⵎⴽⴽⴰⵍⵓⵜⵏ	بالنسبة للأنابيب الداخلية لعجلات للجرافات أو الشاحنات
ⵢⴰⵀ, ⵉⵍⵍⴰ ⵖⴼ ⵎⴷⴷⵏ ⴰⴷ ⵙⵙⵏⵏ ⵎⴰⵙ ⴷ ⵜⵓⵏⵏⵓⵏⵜ ⴰⴷ ⵜⴳⴰ ⴰⵡⴷ ⵜⵓⴱⵖⵉⵔⵜ	نعم على الناس معرفة أن هذه الرياضة مفيدة أيضا
ⴱⵔⵔⴽ ⴰ ⵓⵍⵜⵎⴰ ⵜⵓⴷⴰ	مرحبا بك يا أختي تودا
ⵔⴰⴷ ⴷ ⵓⵔⵔⵉⵖ ⵖⵓⵔ ⵎⴰⵙⵙ ⵓⵃⵙⴰⵢⵏ, ⵎⴰⵢⴷ ⵏⵙⵙⴱⵖⴰⵔ ⵙⴳ ⵜⵖⵔⵉ	أعود إلى السيد أوحساين، ماذا نستفيد من المطالعة
ⴷ ⵙⴳ ⵜⵎⵉⵜⴰⵔ ⵏⵏⵙ ⵢⴰⴹⵏⵉⵏ, ⵉⵍⵉ ⵏ ⵓⵏⵓⵙⵔⵓ ⵏ ⵉⴷⴰⵎⵎⵏ	ومن علامته الأخرى وجود فقر الدم
ⵉⵙ ⵉⴳⴰ ⴰⴼⴰⵔⵉⵙ ⵉⵜⵜⵡⴰⵜⵜⵔⵏ ⵏⵖ ⴷ ⵓⵀⵓ	هل هو منتوج مطلوب أم لا
ⴰⵎⵎ ⵏⵉⵜⵔⵓⵣⴰⵎⵉⵏ ⴷ ⴱⵉⵏⵣⵓⴱⵉⵔⵉⵏ	كالنتروزامين والبينزوبيرين
ⵍⵍⵉ ⵙⴽⴰⵔⵏ ⵉⵎⴰⵔⴰⵡⵏ ⵉ ⵡⴰⵔⵔⴰⵡⵏ ⵏⵏⵙⵏ	الذي يمارسه الآباء على أولادهم
ⴷⴰⵔ ⵛⵛⵉⴼ ⵃⵎⴰⴷ ⴰⴼⴰⴷ ⴰⴷ ⴷⵉⵙ ⵏⴼⵊⵊⵉⵖ ⵙ ⵜⵉⵔⵎⵜ ⵏ ⵡⴰⵙⵙ ⴰⴷ	عند الشيف حماد لنستمتع معه بوصفة اليوم
ⴷ ⴰⵡⴷ ⴳ ⵜⵎⵍⵙⴰ ⵏ ⵉⵔⴳⴰⵣⵏ	وكذا في أزياء الرجال
ⵖⴰⵎⴰⵢⴰⵜ ⴷⵉⵜⵏⵖ ⴰⴼⴰⴷ ⴰⴷ ⵜⵙⵙⵏⵎ ⵉⵙⵢⴰⴼⵓⵜⵏ ⵏⵏⵙⵏ ⵖⴼ ⵡⴰⵣⵣⴰⵔ ⴷ ⵉⵍⴼⵜ	إبقوا معنا لكي تعرفوا منافعها على الشعر والبشرة
ⴰⵏⵎⴳⴰⵍ	العكس
ⵕⵎⴹⴰⵏ ⴰⵎⴱⴰⵔⴽⵉ ⴰⵎⴳⴳⴰⵣ	رمضان مبارك كريم
ⴷⴰⵔⵉ ⵢⴰⵏ ⵓⵙⵇⵙⵉ ⴰ ⵜⴰⴷⵓⴽⵜⵓⵔⵜ ⴰⵎⵉⵏⴰ	لدي سؤال دكتورة أمينة
ⵣⵓⵏ ⴷ ⴰⵏⵓⵙⵔⵓ ⵏ ⵉⴼⵉⵜⴰⵎⵉⵏⵏ ⵏⵖ ⵓⵣⵣⴰⵍ, ⵏⵖ ⴰⵟⵟⴰⵏⵏ ⵢⴰⴹⵏⵉⵏ	كالنقص في الفيتامينات أو الحديد أو أمراض أخرى
ⵓⵀⵓ	لا
ⵏⵙⵔⵙ ⵜⴰⵔⴰⵢⵜ ⵏ ⴽⴰⵡⴽⴰⵡ	نضع طبقة من الفستق
ⵉⵙⵙⵓⵙⵎ ⵉⵢⵉ ⴰⴷ ⴷⵉⵜⵓⵏ ⵎⵎⴰⵇⵇⴰⵔⵖ ⵜⵉⴽⴽⵍⵜ ⵢⴰⴹⵏⵉⵏ	يسرّني أن ألتقي بكم مرة أخرى
ⵉⴳ ⵍⵍⴰⵏ ⵉⵎⵓⴽⵔⵉⵙⵏ ⴰⴷ ⴰⴽⴽⵯ	فبوجود كل هذه المشاكل
ⵔⴰⴷ ⴽⴽⵙⵖ ⵜⴰⵙⴳⵉⵡⵉⵏ	سأزيل الجوانب
ⴰⵎⴰⵏ ⵔⵖⴰⵏ, ⴰⴷ ⵏⵏ ⴳⵉⵙⵏ ⵏⴳ ⵙⴱⴰⴳⵉⵜⵉ	الماء أصبح ساخنا، نضع فيه سباكيتي
ⵖⵉⵍⴰ ⵍⵍⴰⵏⵜ ⵜⵙⵏⵡⴰⴹ	حاليا هناك تسهيلات
ⴷⴰ ⵏⵙⵓⵜⵜⴰⵡ ⵉⵙ ⵜ ⵢⴰⵖ ⵓⴼⵉⵔⵓⵙ ⵏⵖ ⴰⴱⴰⴽⵜⵉⵔⵢⴰ	نحدد هل هو مصاب بفيروس أو بكتيريا
ⵉⵥⴹⴰⵕ ⴰⴷ ⵙⵎⵓⵜⵜⴳⵏ ⵍⵇⵔⴼⴰ ⵎⴰⵛⵛ ⴰⵙⴽⴽⵯⴰⵔ ⵓⵀⵓ	يمكن أن يضعوا القرفة لكن السكر لا
ⴰⵛⴽⵓ ⵉⵔⴰ ⴰⴷ ⵉⵙⵙⵏⴼⵍ ⴰⵏⴰⵡ ⵏ ⵜⵓⴷⵔⵜ ⵏⵏⵙ	لأنه يريد تغيير نمط حياته
ⴷ ⵡⴰⵍⵍⵉ ⴳ ⵍⵍⴰⵏ ⵉⵙⴽⵙⴰⴼ ⴷ ⵏⵜⵜⵏⵉ ⴰ ⵉⴳⴰⵏ ⵍⵎⵓⴹⴰ ⵖⵉⵍⴰ	والذي يحتوي على الزخارف وهي الموضة حاليا
ⵜⴰⵏⵎⵎⵉⵔⵜ ⵏⵏⵓⵏ ⴰⵡⴷ ⵏⴽⵏⵜ	شكرا لكم أيضا
ⴰⵙⵔⴰⴳ ⵏ ⵡⴰⵍⴰⵢ ⵏ ⵓⵎⵔⴰⵔⴰ ⴷ ⵓⴱⵔⴽⵏⵏⵉⵙ	السبب وراء تصاعد التفاعل مع التفاهة
ⵜⵉⵍⵉ ⴷⴰⵔⵏⵖ ⵜⵥⴹⴰⵕⵜ ⵏ ⵓⵙⵏⴼⵍⵓⵍ	وتكون لدينا قدرة على الإبتكار
ⴷ ⵏⴽⴽⵏⵉ ⵓⵔ ⴷⴰ ⵏⵥⵕⵕⴰ ⴰⴳⵏⵙⵓ ⵏ ⵜⵉⵟⵟ ⴷ ⴷⴰ ⴽⴰ ⵏⵙⴽⴰⵔ ⴰⵣⵣⵔⴰⵢ ⵓⵏⵣⵉⵍ	ونحن لا نرى داخل العين ونكتفي بالفحص العادي
ⴳ ⵡⴰⵙⵙ ⴱⵍⴰ ⵜⵏⵜ ⵉⵣⵔⵉ	في اليوم دون تجاوزها
ⵉⵍⵍⴰ ⵖⴼ ⵉⵎⴰⵔⴰⵡⵏ ⴰⴷ ⵎⴰⵜⵔⵏ ⵜⵉⵍⵉⴼⵓⵏⴰⵜ ⵏ ⵡⴰⵔⵔⴰⵡⵏ ⵏⵏⵙⵏ	على الأبوين مراقبة هواتف أبنائهم
ⴰⵏⵓⴽⵎⵓ ⴷⴰⵔ ⵡⵉⵍⵍⵉ ⵉⵍⴽⵎⵏ ⵉⴳⴳⵉ ⵏ ⵙⴰⵎⵔⴰⵡ ⴷ ⵜⴰⵎⵔⴰⵡ ⵏ ⵓⵙⴳⴳⵯⴰⵙ	الاكتئاب لدى منهم فوق السبعين والثمانين سنة
ⵜⵉⵎⵙⴽⴰⵔ ⴰⴷ ⴰⴽⴽⵯ, ⵉⴳ ⵓⵎⵥⵏⵜ ⴰⵣⵔⴼ ⵏⵏⵙⵏⵜ ⵏ ⵜⵓⵍⵖⴰ	فكل هذه السلوكيات إن نالت حقها من المدح
ⴳⴰⵏⵜ ⵜⵉⵖⴰⵡⵙⵉⵡⵉⵏ ⵏ ⵓⵙⴽⵙⴼ ⵏ ⵜⴳⵯⵎⵎⴰ	هي أغراض لتزيين المنازل
ⴰⵛⴽⵓ ⴷⴰ ⵜⵣⵣⵡⴰⵔⴰ ⵜⵉⵖⵔⵉ	فهي تعطي الدراسة الأولوية
ⵖⵉⵍⴰ ⵉⵎⴰⵏⵏⴰⵢⵏ ⵏⵏⵖ ⵔⴰⴷ ⵏⵙⴱⵔⵔⴽ ⴰⵙⵍⵎⴰⴷ ⵄⴰⴱⴷⵓⵍⵍⴰⵀ ⴱⴰⴷⴷⵓ	والآن مشاهدينا سنرحب بالأستاذ عبد الله بادو
ⵏⴳ ⵏⵏ ⵉⵎⵉⴽⴽ ⵏ ⵜⵉⵙⵏⵜ	نضع بعض الملح
ⵓⴷⴰⵏⵜ ⴰⵖ ⴽⵕⴰⴹⵜ ⵜⴳⵍⴰⵢ	سنكتفي بثلاث بيضات
ⴷ ⵓⵖⴰⵡⴰⵙ ⵍⵍⵉ ⴹⴼⵕⵖ	والبرنامج الذي أتبعه
ⴰⵔⴷ ⵜⵏⵡⵓ	حتى تطهى
ⴰⴼⵓⵍⴽⵉ ⵏ ⵓⴼⴳⴰⵏ ⵙⴳ ⵓⴼⵓⵍⴽⵉ ⵏ ⵜⴷⵓⵙⵉ ⵏⵏⵙ	جمال المرء من جمال صحته
ⵓⵔ ⴷⴰ ⵜⵜ ⵉⵙⵎⵓⵍⵍⵓ ⵡⴰⵎⵓⵏ ⵓⵍⴰ ⴰⵔⵔⴰⵡⵏ	لا يرحمها المجتمع ولا الأبناء
ⴰⴼⴰⴷ ⴰⴷ ⵏⵙⴰⵡⵍ ⵖⴼ ⵓⵙⴳⵎⵉ ⵓⵎⵏⵉⴳ	للحديث عن التربية الإيجابية
ⴰⵎⴰⵔⴰ ⵏⵏⵙ ⴰⵎⵉⵔⵉⴽⴰⵏⵉ, ⴷⴰ ⵉⵜⵜⵉⵏⵉ ⵎⴰⵙ ⵓⵔ ⵉⵍⵍⵉ ⵢⵉⵣⵔⵉ ⴷ ⵢⵉⵎⴰⵍ	كاتبه الأمريكي يقول أنه لا وجود للماضي والمستقبل
ⵔⴰⴷ ⵢⵉⵏⵉ ⵜⴰⵎⵚⵕⵉⵜ ⴰⴷ ⵜⵥⵉⵍ	سيقول هذا الصالون جميل
ⵍⵍⴰⵏⵜ ⵎⵏⵏⴰⵡⵜ ⵜⴼⴰⴷⵉⵡⵉⵏ ⴷ ⵉⴱⵖⵓⵔⵏ	هناك شروط عديدة وفوائد
ⵍⵍⵉ ⴳ ⴷⴰ ⵣⵣⵔⴰⵢⵏ ⵉⵎⴰⵔⴰⵡⵏ ⵜⵉⴱⵔⴰⵜⵉⵏ ⵜⵉⵔⵎⵉⴷⵉⵢⵉⵏ ⵙ ⵜⵖⴰⵔⴰⵙⵜ ⵜⴰⵔⴼⵔⴰⴽⵜ	حيث يمرر الوالدين رسائل خاطئة بشكل غير واعي
ⵢⵉⵍⵉ ⵎⴰ ⵉⵙⴽⴰⵔⵏ "ⵙⵏⴰⴱ" ⴰⵛⴽⵓ ⵜⵏⵀⵍ ⵜⵓⴽⴽⵙⴰ ⵏⵏⵙ	وهناك من يلجأ إلى ”سناب“ لأنها سهلة الإزالة
ⵉⴳ ⵓⵔ ⵜⵣⵓⵣⵣⵔⴷ ⵜⵉⵙⵏⵜ, ⵔⴰⴷ ⵜⴽⵛⵎ ⴳ ⵜⴼⴽⴽⴰ ⵏ ⵢⴰⵏ ⵙⴳ ⵡⵉⵍⵍⵉ ⵖⵉⵏⵏ ⵉⵍⵍⴰⵏ	إن لم ترش الملح ستدخل في جسم أحد الحاضرين
ⴹⴼⵕⴰⵜ ⵜⴰⴳⵟⵟⵓⵎⵜ ⵏ ⵓⵖⵓⴷⵓ	تابعوا فقرة الجمال
ⵜⵙⵇⵙⴰⴷ ⵜ ⵖⴼ ⵜⵎⵙⴽⵉⵔⵜ ⵏ ⴽⵔⴰ ⵏ ⵓⵡⵔⵉⴽ ⴳ ⵜⵓⵍⵍⵉⵙⵜ	وتسأله عن تصرف شخصية في القصة
ⵔⴰⴷ ⵏⵙⴰⵡⵍ ⵖⴼ ⵜⵎⵍⵉⵍⵜ ⵏ ⵜⵎⵖⴰⵔⵜ ⴳ ⵍⵎⵖⵔⵉⴱ	سنتكلم عن دور المرأة في المغرب
ⵍⵍⵉ ⵔⴰⴷ ⵉⵎⵣⴰⵔⴰⵢ ⴷ ⵡⴰⵍⴼⴰⴼ	التي ستكون مختلفة عن الستارة
ⵏⵏⵉⵖ ⵎⴰⵙ ⴷ ⵜⴰⵙⵏⴰ ⵉⵏⵓ ⵓⵔ ⵜⵣⵔⵉ ⵉⴼⴹ ⵏ ⵓⵎⴷⴷⴰⴽⴽⵯⵍ	قلت أن صفحتي لا تتجاوز ألف صديق
ⵔⴰⴷ ⴳⵉⵙ ⵙⵔⵙⵖ ⵜⴰⵍⵓⵙⵙⵉ	سأضع فيه القشدة الطرية
ⵉⵥⴹⴰⵕ ⵓⴼⴳⴰⵏ ⵉⴳ ⵉⵙⵙⵏ ⵉⵙ ⵍⵍⴰⵏ ⵙⵎⵎⵓⵙ ⵡⴰⵏⴰⵡⵏ ⴰⴷ	بإمكان الإنسان إذا كان يعلم بوجود هذه الأنواع الخمسة
ⵜⴰⴷⴰ ⵉⴳⴰⵏ ⵜⵉⵍⴰⵡⵜ	هذا هو الواقع
ⴰⵛⴽⵓ ⵉⴼⵙⵙⵓⵙ, ⴰⴽⴷ ⵟⵟⵕⵥ ⴰⵕⴱⴰⵟⵉ	لأنه خفيف، مع الطرز الرباطي
ⴰⵔ ⵏⵥⵕⵕⴰ ⵓⵏⵓⵖ ⵢⴰⴹⵏⵉⵏ ⴳ ⵜⵖⵔⴷⵉⵏ	نرى زخرفة أخرى في الخلف
ⵓⵔ ⴷⴰ ⴳⵉⵙⵏ ⵉⵜⵜⵣⴳⴰ ⵓⴹⴰⵕ	تكون فيها القدم غير مثبتة
ⵉⵜⵜⵓⵙⵙⴰⵏⵏ ⵙ ⵔⵔⵡⴰⵢⵙ ⴷ ⵔⵔⵉⴱⴰⴱ	المعروف بالروايس والرباب
ⵓⵔ ⴷⴰ ⵜⵜⵙⵙⵏⵏ ⵎⴰⵏⵉ ⴳ ⴷⴰ ⵉⵜⵜⵓⴳⴰ ⴱⵓⵜⵓⴽⵙ ⵉⵍⵎⵎⴰ ⴷⴰ ⵙⵔⵓⴳⵏ ⴳ ⵎⵏⵏⴰⵡ ⵉⵎⵓⴽⵔⵉⵙⵏ	لا يعلمون أين يوضع البوطوكس وبالتالي يسببون عدة مشاكل
ⵜⴰⴷ ⵜⴳⴰ ⴰⵙⵜⴰⵢ	وهي إختيارية
ⴰⵢⴰⴷ ⴰ ⵖⴼ ⵉⵍⵍⴰ ⵖⴼ ⵓⴼⴳⴰⵏ ⴰⴷ ⵓⵔ ⵉⵙⵡⵉⵏⴳⵉⵎ ⵎⴰⵙ ⴷ ⴰⴳⵓⴼ ⵉⴳⴰ ⵓⵣⴷⵉⵔ	لهذا يجب على الإنسان ألا يفكر بأن الفشل شيء سلبي
ⵎⴰⵛⵛ ⵉⵇⵇⴰⵏ ⴷ ⴰⴷ ⵏⵙⵜⵉ ⵎⴰⵏⵡⴰ ⴷ ⴷⴰ ⵏⵙⴰⵡⴰⵍ	لكن يجب أن نختار مع من نتحدث
ⵏⵡⴰⴷⵙ ⵣⵓⵏ ⴷ ⵜⵉⵏⵉⵔⵉⵏ ⴰⴷ ⴳⵉⵙⵏⵜ ⵎⵏⵏⴰⵡ ⵡⴰⵏⴰⵡⵏ	نقصد مثل هذه الشمعات ومنها أنواع عديدة
ⴷⴰ ⵜⵜⵉⵍⵉⵏⵜ ⴳ ⴽⵔⴰ ⵏ ⵜⴽⴽⴰⵍ ⵜⵓⵜⵜⵔⵉⵡⵉⵏ ⵜⵉⵎⵇⵔⴰⵏⵉⵏ	تكون هناك في بعض الأحيان طلبيات كبيرة
ⵏⵙⵎⴰⵙⵙ ⵜ ⴰⴼⴰⴷ ⴰⴷ ⵓⵔ ⵉⵙⵍⵖ	نحركه لكي لا يلتصق
ⴽⵓⴷⵏⵏⴰ ⵜⵏⵏⵉⴷ "ⵓⵀⵓ" ⵉ ⵎⴷⴷⵏ	حينما تقول "لا" للناس
ⴷ ⵉⵍⵍⴰ ⴼⵍⵍⴰⵖ ⴰⴷ ⵓⵔ ⵏⵎⵎⵜ ⵎⵉⵏ ⴰⴷ ⴳⵉⵙ ⵏⴼⵍ ⵜⴰⵎⴰⵜⴰⵔⵜ ⵏⵏⵖ	و يجب أن لا نموت بدون ترك بصمتنا فيها
ⴷ ⴽⵔⴰ ⵏ ⵜⴽⴽⴰⵍ ⴷⴰ ⵉⵜⵜⴳⴳⴰ ⴰⴽⴰⵏⵚⵉⵕ	وأحيانًا يكون سرطانًا
ⵉⵙ ⵜⵍⵍⴰ ⵜⵙⵏⵉⵊⵊⵉⵜ ⵉⵜⵜⴰⵡⵙⵏ ⴳ ⵡⵓⵏⵓⴼ ⵏ ⵜⵎⵉⵜⴰⵔ ⵏ ⵜⵡⵙⵔⴰ?	هل هناك طب يساعد في تجنب أعراض الشيخوخة؟
ⵣⵓⵏ ⴷ ⴰⵙⴳⴳⴰⵏ ⴷ ⵓⵎⵣⴰⵜⵉⵎ ⴷ ⵓⵣⴳⴳⵯⴰⵖ ⵉⵖⵎⴰⵏ	كالأسود والزيتي والأحمر الداكن
ⴷ ⵉⴳ ⴳⵉⵙ ⵜⵙⵡⵉⴷ ⵖⵙ ⵢⴰⵜ ⵜⵎⵇⵇⵉⵜ, ⵉⵥⴹⴰⵕ ⴰⴷ ⵉⵙⵔⴳ ⴳ ⵓⴽⴰⵏⵚⵉⵕ ⵏ ⵜⴰⵙⴰ	وإذا ما شربت منه قطرة واحدة قد يسبب سرطان الكبد
ⵉⵇⵇⴰⵏ ⴷ ⴰⴷ ⴳⵉⵙ ⵢⵉⵍⵉ ⵓⵙⵎⵓⵜⵜⴳ ⵏⵏⵙ	و يجب الحصول على تكوين خاص بها
ⵜⵉⴽⵚⵚⴰⴹ ⵜⵓⵏⵣⵉⵍⵉⵏ	الخوف العادي
ⴷ ⵉⵙ ⴷ ⵜⴰⵖⴰⵡⵙⴰ ⴰⴷ ⴷⴰⵔⵙ ⵜⵓⵇⵇⵏⴰ ⴷ ⵜⵓⴳⵜⵜ ⵏ ⵓⵎⵓⵙⵙⵓ	وهل لهذا الأمر علاقة بفرط الحركة
ⴷⴰ ⵉⵜⵜⵉⵍⵉ ⴰⵢⴰⴷ ⴳ ⵢⴰⵜ ⵜⵉⵔⵎⵜ	يتم هذا في حصة واحدة
ⴽⵔⴰ ⵏ ⵜⴽⴽⴰⵍ ⴷⴰ ⵉⵜⵜⴰⵥⵎ ⴰⴼⴳⴰⵏ ⵢⴰⴹⵏⵉⵏ	أحيانا يلوم الشخص الآخر
ⵜⴰⵔⵔⴰⵡⵜ ⴰⵡⴷ ⵏⵜⵜⴰⵜ ⵜⵔⴳⵍ ⵖⴼ ⵢⵉⵅⴼ ⵏⵏⵙ ⴳ ⵓⴳⵏⵙⵓ ⵏ ⵓⵃⴰⵏⵓ ⵏⵏⵙ	البنت كذلك تقفل على نفسها داخل غرفتها
ⴷ ⵓⵙⵔⴰⴳ ⵏ ⵓⵏⴳⵉⵙ ⵉⴳⴰ ⵜ ⵢⴰⵏ ⵢⴰⴹⵏⵉⵏ	وسبب الصدمة شخص آخر
ⴷⴰ ⵙⵎⵣⴰⵣⴰⵍⵏ ⵉⵖⴼⴰⵡⵏ ⵏⵏⵙⵏ ⴷ ⵡⵉⴷ ⵉⵏⵉⵏ ⵙⵎⴰⵇⵇⵍⵏ ⵎⴰⵙ ⵓⵔ ⴳⵉⵏ ⵉⵎⴰⵏⵏⴰⵣⵏ	يقارنون أنفسهم بهؤلاء ويقولون ويعتبرون أنهم غير محظوظين
ⵉⵍⵍⴰ ⵖⵓⵔⵓⵏ ⴰⵡⴷ ⴰⴼⴰⵔⵉⵙ ⵏ ⵜⴰⵎⵎⵏⵜ	لديكم أيضا منتوج العسل ما شاء الله
ⴳ ⵓⵙⴳⴳⵯⴰⵙ 2012 ⴷ ⴷⵔⵓⵖ ⴷⴰⵖ ⴳ ⵓⵙⴳⴳⵯⴰⵙ 2016 ⴳ ⵓⵏⵎⵓⵇⵇⴰⵔ ⵏ ⵔⵔⵉⴱⴰⴱ	لسنه 2012 وجاءت مشاركة أخرى سنه 2016 في ملتقى الرباب
ⵜⵙⵙⵏⴷ ⵎⴰⵙ ⵜⴷⴷⵔⴷ ⴰⴼⵔⴰ ⴰⴳⵏⵙⴰⵏ	وتدرك أنك تعيش سلامًا داخليًا
ⵎⴰⵅⵅ ⵓⵔ ⵍⵍⵉⵏⵜ ⵜⵎⵖⴰⵔⵉⵏ ⵜⵉⵎⵥⴰⵡⴰⵏⵉⵏ ⴳ ⵓⴳⴰⴷⵉⵔ	لماذا لا توجد نساء عازفات في أكادير
ⵙ ⵓⵙⵔⴰⴳ ⵏ ⵡⴰⵍⴰⵢ ⵏ ⵓⴼⵔⴰⴽ ⵉⵍⵉⵏ ⵡⴰⴷⴷⴰⴷⵏ ⵉⵎⵛⴰⵛⴽⴰⵏ	بفضل إرتفاع الوعي وتوفر الظروف المناسبة
ⴷ ⵔⴰⴷ ⵏⵙⵏⴱⴳⵉ ⴰⴷⵓⴽⵜⵓⵔ ⵄⴱⴷⵓⵍⵍⴰⵀ ⴱⴰⵀⴰ	كما سنستضيف الدكتور عبدالله باها
ⵍⵍⴰⵏ ⴽⵔⴰ ⵏ ⵎⴷⴷⵏ ⴷⴰⵔⵙⵏ ⴰⵟⵟⴰⵏ ⵏ ⵢⵉⵎⵉ ⵏ ⵜⴷⵉⵙⵜ	هناك بعض الناس يعانون من مرض فم المعدة
ⵉⵍⵎⵎⴰ ⴷⴰ ⴼⵍⵍⴰⵖ ⵉⵜⵜⵉⵍⵉ ⴰⴷ ⵏⵙⵎⴰⵢⵏⵓ ⵜⵓⵎⵎⵍⴰ ⴳ ⵜⵡⵓⵔⵉ ⵏⵖ ⵉⵡⵍ	لهذا نكون مطالبين بتجديد النية في حال العمل أو الزواج
ⴷ ⵓⵎⵉⴽⵔⵓⴱ ⴰⵛⴽⵓ ⵉⵣⵣⵔⵉ ⵜⴰⵎⵀⵍⵜ ⵏ ⵓⴼⵍⴰⵢ	والميكروب لأنه خضع لعملية جراحية
ⴷ ⵖⵉⴷ ⴰ ⴳ ⵉⵍⵍⴰ ⵓⵎⵣⴰⵔⴰⵢ ⴳⵔⴰⵜⵙⵏ	وهنا مكمن الإختلاف بينهما
ⵙⵙⵏⵖ ⵎⴰⵢⴷ ⵓⵙⵔⵖ	و أعرف ما أحتاجه
ⴰⴷⵓⵙ ⵏ ⵚⵚⵓⵢⴰ ⴷⴰ ⵉⴼⵙⵙⵉ ⴳ 70° ⵏ ⵜⵙⴽⵯⴼⵍⵜ	فشمع الصويا يذوب في 70° درجة
ⴰⴼⴰⴷ ⴰⴷ ⴰⵙⵏ ⵏⵣⵣⵔⵉ ⵜⴰⵖⴰⵔⴰⵙⵜ ⵉⵕⵡⴰⵏ	حتى ننقل إليهم الطريقة السليمة
ⴰⵏⴳⴰⴹ ⵍⵍⵉ ⴳ ⴷⴰ ⵏⵥⵕⵕⴰ ⵎⴰⵙ ⴷ ⵎⴷⴷⵏ ⵓⵔ ⵥⴹⵉⵕⵏ	الإدمان حيث نرى أن الأشخاص لا يستطيعون
ⵢⵉⵎⵖⵓⵔ ⵡⴰⵣⵣⴰⵏ ⵉⵍⴽⵏ	فيكبر الطفل متيقنا
ⴷⴰ ⵏⵏ ⵜⴻⵜⵜⴰⴼⴰⴷ ⵎⴰⵙ ⴷ ⴰⵣⴳⵏ ⵏ ⵡⴰⴽⵓⴷⵏ ⵓⵔ ⵜⵙⵙⵉⵏⴷ ⵎⴰⵏⵉ ⴳ ⴷⴷⴰⵏ	تجدين أن هناك نصف أوقاتا لا تعرفين أين تم تضيعها
ⴽⵓⴷⵏⵏⴰ ⵜⵜ ⵉⵙⵙⵏⴼⵍ ⴳ ⵜⵓⵥⵥⵓⵎⵜ ⵏ ⵓⵏⵡⴰⵍ ⵉⵔⵖ ⴳⵉⵙ ⵡⴰⴼⴰ	حين يغيرها وسط المطبخ وتشتعل فيها النار
ⴷ ⵉⵥⴹⴰⵕ ⵓⵎⵓⴽⵔⵉⵙ ⴰⵡⴷ ⵏⵜⵜⴰ	ويمكن للمشكل أيضا
ⴰⵛⴽⵓ ⵉⵍⴽⵎ ⵢⴰⵏ ⵡⴰⴷⴷⴰⴷ ⵏ ⵜⴽⵕⴹⵉ ⵜⴰⴳⵏⵙⴰⵏⵜ ⵉⵇⵇⴰⵏ ⴷ ⴰⴷ ⴷ ⵜⴼⴼⵖ	لأنه بلغ حالة من العنف الداخلي يجب تصريفها
ⵉⵎⴰ ⴷⴷⴰⵡ 18 ⵏ ⵓⵙⴳⴳⵯⴰⵙ	أما أقل من 18 سنة
ⴳ ⵜⴳⵎⵉ ⵏ ⵜⴼⵍⵙⵉⵎⴰⵏⵜ	على تنمية الثقة بالنفس
ⴰⴼⴰⴷ ⴰⴷ ⵜⴰⵏⴼ ⴰⴷ ⵉⵍⵉⵏ ⵉⵎⵓⴽⵔⵉⵙⵏ ⴷ ⵡⴰⵣⵣⴰⵏ	لتجنب أن يعاني الطفل من مشاكل
ⵜⵓⵥⵥⵓⵎⵜ ⵏ ⵓⵙⵏⴼⵍ ⴰⴷ ⵎⴰⵏⵎⴽ ⵏⵜⵜⵎⵔⴰⵔⴰ ⴷ ⵉⵎⵓⴽⵔⵉⵙⵏ?	وسط هذا التغيير كيف نتعامل مع المشاكل؟
ⵉⵥⴹⴰⵕ ⴰⴷ ⵉⵙⵙⴰⵡⵙ ⵙ ⵉⵎⵙⵙⴰⵏⵓⵏⵏ ⴷ ⵉⵎⴰⵣⵣⴰⴳⵏ ⴳ ⵜⴳⵎⵉ ⵏ ⵜⵥⴹⴰⵕⵉⵏ ⴷ ⵉⴼⵓⴽⵙⵏ	بإمكانه الإستعانة بمدربين وأخصائين في تنمية القدرات والمهارات
ⵉⴳⴰ ⵜ ⵍⵍⵉⴳ ⵜⵜ ⵓⵔ ⴽⴽⵉⵏ ⴰⵔ ⵜⵜⴳⴰⵡⴰⵔⵏ ⴷ ⵡⴰⵔⵔⴰⵡⵏ ⴳ ⵜⵎⵥⵉ ⵏⵏⵙⵏ	هو أنهم لم يكونوا يجالسون الأبناء في صغرهم
ⴷⴰ ⵜⵙⵏⵔⵏⴰⵢ ⴳ ⵜⵏⴼⵍⴰⵍⵉⵜ ⵏ ⵜⴰⵥⴰⵢⵜ	تزيد من مظهر الوزن
ⵉⵙ ⴷⴰ ⵜⴻⵜⵜⵎⵓⵜⵜⵓⵢ ⵙⴳ ⵓⴼⴳⴰⵏ ⴰⵔ ⵡⴰⵢⵢⴰⴹ	هل تنتقل من شخص لآخر
ⵉⵇⵇⴰⵏ ⴷ ⴰⴷ ⵏⵔⴰⵔ ⵜⴰⵢⵏⵉⵜ ⴳ ⵜⵉⵣⵉ ⵏ ⵡⵓⵔⴰⵔ ⵏⵏⵙⵏ ⵜⴰⵎⴰ ⵏ ⵓⴷⵖⴰⵔ ⵏ ⵜⵡⵓⵔⵉ ⵏ ⵜⵢⵎⵎⴰⵜⵉⵏ	يجب توخي الحذر أثناء لعبهم قرب مكان إشتغال الأمهات
ⴷⴰ ⵜⵜⴷⴷⵓⵏ ⵙⴳ ⵓⵙⵓⵏ ⵙ ⵡⴰⵢⵢⴰⴹ	يذهبون من قرية إلى أخرى
ⵍⵍⵉ ⴳ ⴷⴰ ⵉⵕⵥⵥⵎ ⵜⵉⵖⵔⴰⵙⵉⵏ ⴷ ⴷⴰ ⵙⵉⵙⵏⵜ ⵉⴽⵛⵛⵎ	حيث تفتح الخلايا وتدخل إليها
ⵜⴳⴰ ⴰⴷ ⵜⴽⴽⵙⴷ ⴰⵣⴷⴰⵢ ⵏⵏⴽ ⴷ ⵜⵖⴰⵡⵙⵉⵡⵉⵏ ⵜⵓⵣⴷⵉⵔⵉⵏ ⵏ ⵢⵉⵣⵔⵉ	هي فك إرتباطك بالأمور السلبية الماضية
ⵉⵇⵇⴰⵏ ⴷ ⴰⴷ ⵏⵙⵎⵓⵜⵜⴳ ⵙⴽⵙⵓ ⴰⵙⵙ ⵏ ⵓⵙⵉⵎⵡⴰⵙ	يجب أن نحضر الكسكس يوم الجمعة
ⵡⴰⴷ ⵉⴳⴰ ⵢⴰⵏ ⵡⴰⵏⴰⵡ ⵏ ⵓⵣⵓⵅⵓ	هذا يعتبر شكلا من أشكال التنمر
ⴷ ⵉⵙ ⵉⴼⵔⴽ ⵎⴰⵙ ⴷ ⵜⵓⴳⵜⵜ ⵏ ⵜⵖⴰⵡⵙⵉⵡⵉⵏ ⵓⵔ ⵔⴰⴷ ⴷⴰⵔⵙ ⵉⵍⵉⵏⵜ	وهل هو واع بأن العديد من الأشياء لن توفر له
ⴽⵔⴰ ⵏ ⵜⴽⴽⴰⵍ ⴷⴰ ⵜⴻⵜⵜⴷⴷⵓ ⵙ ⵜⵎⵚⵕⵉⵜ	أحيانا تذهب إلى الصالون
ⵜⵉⵙⵙ ⵙⵏⴰⵜ, ⵜⵓⴳⵜⵜ ⵏ ⵜⵙⵎⵎⵉ ⴷ ⴰⵡⴷ ⵉⵍⵉ ⵏ ⵜⵊⵕⵊⵓⵎⵜ ⴰⵏⵏ	ثانيا كثرة الحموضة وكذلك حضور تلك الجرثومة
ⴷⴰ ⴷⵉⵙⵏ ⵜⵜⵎⵔⴰⵔⴰⵖ ⵙⵖⵖ ⴷⴰⵔⵙⵏ ⵉⵙⵓⵜⴰⵢ ⴰⴷ	أتعامل معهم و أقتني منهم هذه الإطارات
ⵍⵍⵉ ⵉⴳⴰⵏ ⴰⵜⵜⴰⵢⵏ ⵏ 14 ⵏ ⵓⵙⴰⴽⴰ	والتي هي تقريبا 14 مسارا
ⴰⵛⴽⵓ ⴰⵎⵣⴳⵓⵏ ⵉⵎⵔⴰ	لأن المسرح صعب
ⴷⴰ ⵜⵜⴳⴰⵎⵎⴰⵢⵏ ⴰⴷ ⵜⵜ ⵙⵙⵓⴳⵓⵏ ⵙ ⵜⵖⴰⵔⴰⵙⵜ ⵜⴰⴷⵓⵙⴰⵏⵜ	يعجزون عن تفريغها بطريقة صحية
ⵎⴰⵙ ⴷⴰ ⵜⵏ ⵜⵙⵎⵎⵜⴰⵔⴷ?	بماذا تنصحهم؟
ⵏⵖ ⵉⴳⴰ ⵓⵔⴰⵔ ⵏⵏⴰ ⵙ ⵜ ⵙⵡⴰⵍⴰⵏ ⵉⵎⴰⵔⴰⵡⵏ ⵏⵏⵙ	أو يكون لعبا يوجهه له والديه
ⵏⴽⴽⴰ ⵜⵜ ⵉⵏⵏ ⴰⵔ ⵢⴰⴷⵍⵍⵉ ⵏⵙⴰⵡⴰⵍ	كنا نتحدث سابقا
ⵙⴳ ⵜⵖⴰⵡⵙⵉⵡⵉⵏ ⵉⵀⵔⵛⵏ ⵜⴳⴰ ⵍⵍⵉ ⵓⵔ ⵉⵍⵍⵉ ⵓⵎⴰⵜⵔ	من بين الأمور السيئة هو إنعدام المراقبة
ⴰⵛⴽⵓ ⵓⵔ ⵜⵜ ⵉⵏⵏ ⵉⴽⴽⵉ ⴰⵎⵔ ⴰⵖⴰⵏⵉⵎ	لأنه في السابق لم يكن سوى القصب
ⵍⵍⵉⴳ ⴷⴷⵔⵏ ⴰⵢⵏⵏⴰ ⵏⵉⵜ ⴳ ⵜⵎⵥⵉ ⵏⵏⵙⵏ	أنهم عاشوا نفس الشيء في طفولتهم
ⴽⵛⵎ ⴷ ⵔⴰⴷ ⵜⴰⴼⴷ ⴽⵔⴰⵢⴳⴰⵜⵜ ⵜⴰⵖⴰⵡⵙⴰ ⵜⵍⵍⴰ	أدخل وستجد كل شيء متاحا
ⴷⴰ ⵜⵜ ⵜⵜⴹⴼⵕⵏ ⵉⵔⴳⴰⵣⵏ ⴰⴽⴽⵯ	يتبعها كل الرجال
ⴷⴰ ⵜ ⵙⵙⵎⵔⴰⵙⵏ ⵎⴷⴷⵏ ⵍⵍⵉ ⴷⴰⵔ ⵉⵍⵍⴰ ⴽⵔⴰ ⵏ ⵓⵎⵓⴽⵔⵉⵙ	يستعمله الأشخاص الذين يعانون من مشكل ما
ⵜⴰⵖⴰⵡⵙⴰ ⵢⴰⴹⵏⵉⵏ ⵏⵏⴰ ⵉⴳⴰⵏ ⵜⴰⵎⵙⴰⴷⵓⵔⵜ ⴷ ⵜⵓⵛⵛⵍ	شيء آخر وهو التغذية وهي ضرورية
ⴷ ⵎⴰ ⵉⴳⴰ ⵡⴰⵏⴰⵡ ⵏⵏⵙ ⴷ ⵎⴰⵏⵎⴽ ⵔⴰⴷ ⴰⵙ ⵉⵙⵓⵊⵊⵉ	وما نوعه وكيف سيعالجه
ⵙⴳⵉⵙⵏ ⵡⴰⵔ ⵉⵎⵓⵙⵍⵎⵏ ⴷ ⵉⵎⵓⵙⵍⵎⵏ ⵉⵄⵕⴰⴱⵏ	منهم غير المسلمون والمسلمون العرب
ⵔⴰⴷ ⵜⴰⵊⵊ ⵜⵉⵏⵉⴹⵉ ⴰⴷ ⵜⵏⵖⵓⴱⵓ	ستجعل الصناعة التقليدية تندثر
ⵢⵉⵍⵉ ⵎⴰ ⵉⵙⵙⵓⵏⵓⵖⵏ ⵖⴼ ⵜⵖⴰⵡⵙⵉⵡⵉⵏ ⵢⴰⴹⵏⵉⵏ	و هناك من يرسم على أشياء أخرى
ⴷⵓⴽⵜⵓⵔ ⴱⴰⵀⴰ ⴷ ⵜⴷⵓⴽⵜⵓⵔⵜ ⴰⵢⵜ ⵙⵉⴷⵉ ⵄⵍⵉ	دكتور باها ودكتورة أيت سيدي علي
ⴷⴰ ⴱⴷⴷⴰ ⵏⵜⵜⴱⴰⴹ ⵖⴼ ⵜⵖⴰⵡⵙⵉⵡⵉⵏ ⵙ ⵜⵓⵔⵎⵉⵢⵉⵏ ⵏ ⵡⵉⵢⵢⴰⴹ	نحكم دائما على الأشياء من خلال تجارب الآخرين
ⴷ ⴰⴷ ⴰⵙ ⵜⵙⵙⵍⵎⴷ ⵜⵓⵜⵍⴰⵢⵜ ⵜⴰⵎⴰⵣⵉⵖⵜ ⴷ ⵜⵄⵕⴰⴱⵜ ⴷ ⵜⴼⵕⴰⵏⵙⵉⵙⵜ ⴷ ⵜⵓⵜⵍⴰⵢⵉⵏ ⵢⴰⴹⵏⵉⵏ	وتعليمه اللغة الأمازيغية والعربية والفرنسية ولغات أخرى
ⵏⵙⵎⵔⴽⵯⵍⵍⵉ ⵜ ⴳⵉⵙ	و نلفه فيه
ⵜⵍⵍⴰ ⵙⴳ ⵓⵣⵎⵣ ⵏ ⵉⴼⵔⵄⵓⵏⵏ	هو موجود من عهد الفراعنة
ⴳ ⵜⵉⵣⵉ ⴰⵏⵏ ⵉⴳ ⵉⵔⴰ ⵓⵎⵙⵢⴰⴼⵓ ⴰⴷ ⴰⴽ ⵉⴼⴰⵔⵙ ⵢⴰⵜ ⵜⵡⵓⵔⵉ	بتلك الفترة إذا أراد المنتج أن ينتج لك عملا
ⵜⵉⴼⵙⵜ ⵜⴳⴰ ⵜⵉⵏ ⵢⵉⴹ ⴷ ⵓⵣⴰⵍ	فالتوب ليلي نهاري
ⴷ ⵡⴰⵔⵔⴰⵡⵏ ⵓⵔ ⴳⵉⵏ ⵜⵉⵍⵉⵜ ⵏⵏⵖ, ⵎⴰⵛⵛ ⴳⴰⵏ ⵖⴰⵙ ⵢⴰⵜ ⵜⵏⴰⴼⵓⵜ	فالأبناء ليسوا ملكا لنا بل مجرد نعمة
ⵉⵍⵎⵎⴰ ⵜⴰⴳⴳⵯ ⴷ ⵜⵜⵉⵇⵏⵉⵜ ⵏ ⵓⵙⵎⵎⴰⵎ ⵏ ⵢⵓⵔⵓⵏⵉⴽ	و بعد ذلك ظهرت تقنية حمض اليورونيك
ⵉⵙⵎ ⵉⵏⵓ ⵚⴰⴱⴰⵃ	إسمي صباح
ⴰⵔ ⵙⵓⵍ ⵜⵜⵇⵇⵍⵖ مازلت أنتظر
ⵇⵇⵍ ⵙⵉⵜⵉ  انتظرني
ⵉⴳⴰ ⴰⵏⵉⵍⵉ إنه أزرق
ⵓⵔ ⴳⵉⴽ ⴷⵎⵉⵖ ⴰⵢⴰⴷ خاب ظني فيك
ⵔⴰⴷ ⴳⵖ ⴰⵢⵍⵍⵉ ⵔⵉⵖ  سأكون ما أريد
ⴼⵍⵙⵖ ⴽ  صدقتك

