DNA: ⵙⵎⴽ
English:  ⵜⴰⵏⴳⵍⵉⵣⵜ
Maris: ⵎⴰⵔⵉⵙ
Marisughl:  ⵎⴰⵔⵉⵙⵓⵖⵍ
Mohamed:  ⵎⵓⵃⵎⵎⴰⴷ
abilities:  ⵜⵉⵣⵎⵎⴰⵔ
ability:  ⵜⴰⵣⵎⵔⵜ
about:  ⵖⴼ
absolutely: ⵏⵉⵜ
abstract: ⴰⵎⴷⵡⴰⵏ
acceleration: ⴰⵏⵉⵎⵎⵔ
accelerator: ⴰⵎⵙⵉⵎⵎⵔ
accelerators: ⵉⵎⵙⵉⵎⵎⴰⵔ
access: ⴰⴷⴷⴰⴼ
account: ⴰⵎⵉⴹⴰⵏ
accounts: ⵉⵎⵉⴹⴰⵏⵏ
accuracy: ⵜⵉⵙⴷⴷⵉ
acid: ⴰⵙⵎⵎⴰⵎ
acids: ⵉⵙⵎⵎⴰⵎⵏ
action: ⵜⵉⴳⴰⵡⵜ
actions: ⵜⵉⴳⴰⵡⵉⵏ
activation: ⴰⵙⵔⵎⴷ
activities: ⵉⵔⵎⵓⴷⵏ
activity: ⴰⵔⵎⵓⴷ
adaptation: ⴰⵙⵙⵣⴳⵉ
adapter: ⴰⵎⵙⵙⵣⴳⵉ
addition: ⴰⵙⵎⵔⵏⵉ
additional: ⴰⵎⵔⵏⴰⵡ
additivity: ⵜⴰⵎⵔⵏⴰ
address: ⵜⴰⵏⵙⴰ
adenosine: ⴰⴷⵉⵏⵓⵣⵉⵏ
administration: ⵜⴰⵎⵙⵙⵓⴳⵓⵔⵜ
adult: ⴰⵎⵜⵔⵓⴳ
advantage: ⴰⴱⵖⵓⵔ
adventure: ⵜⴰⵎⵙⴽⵙⴰⵍⵜ
advice: ⴰⵙⵎⵎⵜⵔ
africa: ⵜⴰⴼⵔⵉⵇⵜ
after: ⴹⴰⵕⴰⵜ
afternoon: ⵜⴰⴷⴳⴳⵯⴰⵜ
again: ⴷⴰⵖ
against: ⵎⴳⴰⵍ
age: ⴰⵡⵜⴰⵢ
ages: ⵉⵡⵜⴰⵢⵏ
agriculture: ⵜⴰⴽⵔⵣⴰ
air: ⴰⵣⵡⵓ
airport: ⴰⵣⴰⴳⵯⵣ
alfalfa: ⴰⵡⵔⵉ
algebra: ⴰⵍⵊⵉⴱⵔ
algebraic: ⴰⵍⵊⵉⴱⵔⴰⵏ
algorithm: ⵜⴰⵅⴰⵡⴰⵔⵉⵣⵎⵉⵜ
algorithms: ⵜⵉⵅⴰⵡⴰⵔⵉⵣⵎⵉⵢⵉⵏ
alien: ⴰⵎⵙⴰⵢⵔⴰⵔ
alien: ⵉⵎⵙⴰⵢⵔⴰⵔⵏ
all: ⴰⴽⴽⵯ
alliance: ⴰⵎⵓⵍⵍⵉ
already: ⵢⴰⴷⵍⵍⵉ
also: ⴰⵡⴷ
alternance: ⵜⴰⵎⵍⴻⵍⵍⵉⵜ
alternative: ⴰⵎⵍⴰⵍⵍⴰⵢ
although: ⵎⵇⵇⴰⵔ
alum: ⴰⵥⴰⵔⵉⴼ
always: ⴱⴷⴷⴰ
amazigh: ⵜⴰⵎⴰⵣⵉⵖⵜ
ambiguity: ⴰⵎⵎⵔⵡⵉ
america: ⵎⴰⵔⵉⴽⴰⵏ
amoeba: ⴰⵎⵉⴱⴰ
amphibian: ⴰⵎⴽⴰⵍⵎⴰⵏ
amphibians: ⵉⵎⴽⴰⵍⵎⴰⵏⵏ
analogy: ⵜⴰⵔⵡⵙⵜ
analysing: ⴰⵚⵍⴰⴹ
analysis: ⴰⵚⵍⴰⴹ
analyzing: ⴰⵚⵍⴰⴹ
anatomical: ⴰⴼⵍⴰⵢⴰⵏ
anatomy: ⴰⴼⵍⴰⵢ
ancient: ⴰⵇⴱⵓⵔ
and: ⴷ
angle: ⵜⵉⵖⵎⵔⵜ
animal: ⴰⵎⵓⴷⵔ
animals: ⵉⵎⵓⴷⴰⵔ
animater: ⴰⵎⵙⵉⴷⵔ
animation: ⴰⵙⵉⴷⵔ
animation: ⴰⵙⵎⵓⵙⵙⵓ
animations: ⵉⵙⵎⵓⵙⵙⵓⵜⵏ
annulation: ⵜⵓⵙⵙⵔⴰ
anonymous: ⵓⴷⵔⵉⴳ
another: ⵢⴰⴹⵏ
ant: ⵜⴰⵡⵟⵟⵓⴼⵜ
ants: ⵜⵉⵡⴹⴼⵉⵏ
antibody: ⴰⵎⴳⵍⴼⴽⴽⴰ
anus: ⴰⵚⵓⴹ
any: ⴽⵔⴰⵢⴳⴰⵜⵜ
anybody: ⴽⵔⴰ ⵏ ⵢⴰⵏ
anyone: ⴽⵔⴰ ⵏ ⵢⴰⵏ
anything: ⵜⵖⴰⵡⵙⴰ ⵏⵏⴰ
app: ⵜⵉⵙⵏⵙⵉ
apple: ⵜⴰⴷⴼⴼⵓⵢⵜ
apples: ⵜⵉⴷⴼⴼⵓⵢⵉⵏ
application: ⴰⵙⵏⴰⵙ
applications: ⵉⵙⵏⴰⵙⵏ
applied: ⵉⵜⵜⵓⵙⵏⴰⵢⵏ
approach: ⵜⴰⵎⵢⴰⴷⴰⵙⵜ
approaches: ⵜⵉⵎⵢⴰⴷⴰⵙⵉⵏ
appropriate: ⵉⴱⵓⵏⴰⵏ
appropriate: ⵉⴱⵓⵏⴰⵏ
approximately: ⵙ ⵡⴰⵜⵜⴰⵢⵏ
apps: ⵜⵉⵙⵏⵙⵉⵡⵉⵏ
april: ⵉⴱⵔⵉⵔ
arabic: ⵜⴰⵄⵕⴰⴱⵜ
architecture: ⵜⴰⵙⴳⴷⴰ
area: ⵜⴰⵊⵓⵎⵎⴰ
areas: ⵜⵉⵊⵓⵎⵎⴰⵡⵉⵏ
argument: ⵜⵉⵖⵉⵔⵜ
arguments: ⵜⵉⵖⵉⵔⵉⵏ
arithmetic: ⵜⴰⵙⵏⵎⴹⴰⵏⵜ
arm: ⵉⵖⵉⵔ
arms: ⵉⵖⴰⵔⵉⵡⵏ
array: ⵜⴰⴼⵍⵡⵉⵜ
arrays: ⵜⵉⴼⵍⵡⵉⵏ
art: ⵜⴰⵥⵓⵔⵉ
article: ⴰⵎⴳⵔⴰⴷ
articles: ⵉⵎⴳⵔⴰⴷⵏ
articulation: ⴰⴳⵙⵓⵙⵔⵓ
artificial: ⴰⵙⵎⴳⵓⵔ
artistic: ⴰⵥⵓⵕⴰⵏ
asia: ⴰⵙⵢⴰ
aspect: ⴰⵎⴰⵖⵏⵓ
aspects: ⵉⵎⴰⵖⵏⵓⵜⵏ
assembly: ⴰⵙⴳⵔⵓ
assertion: ⴰⵇⵇⵉⵔ
assigning: ⴰⵙⴷⵓⴽⴽⵍ
assignment: ⴰⵙⴷⵓⴽⴽⵍ
assimilation: ⵜⴰⵎⵙⵔⵜⵉⵜ
assistant: ⴰⵎⴰⵡⴰⵙ
association: ⵜⴰⵎⵙⵎⵓⵏⵜ
associations: ⵜⵉⵎⵙⵎⵓⵏⵉⵏ
asterisk: ⵜⵉⵜⵔⵉⵜ
asteroid: ⴰⵣⵓⵏⵜⵔⵉ
asteroids: ⵉⵣⵓⵏⵜⵔⵉⵜⵏ
astrology: ⴰⵙⵜⵔⵉ
astronomer: ⴰⵎⵙⵏⵉⵜⵔⵉ
astronomy: ⵜⴰⵙⵏⵉⵜⵔⵉⵜ
astrophysicist: ⴰⵎⵙⵏⴳⴰⵎⵉⵜⵔⵉ
astrophysicists: ⵉⵎⵙⵏⴳⴰⵎⵉⵜⵔⵉⵜⵏ
astrophysics: ⵜⴰⵙⵏⴳⴰⵎⵉⵜⵔⵉⵜ
at: ⴳ
atmosphere: ⵜⵉⴳⵏⵡⵜ
atom: ⴰⴱⵍⴽⵉⵎ
atomic: ⴰⴱⵍⴽⴰⵎ
atoms: ⵉⴱⵍⴽⵉⵎⵏ
attack: ⴰⵥⴹⴰⵎ
attempt: ⵜⵓⵔⵎⵉⵜ
attempts: ⵜⵓⵔⵎⵉⵜⵉⵏ
attention: ⵜⴰⵢⵏⵉⵜ
attestation: ⴰⵙⵍⴽⵉⵏ
attribute: ⴰⵏⴰⵎⴰⵥ
attributes: ⵉⵏⴰⵎⴰⵥⵏ
audibility: ⵜⴰⵙⵍⵍⵉⵜ
audio: ⴰⵎⵙⵍⴰⵡ
auditeur: ⴰⵎⵙⵙⴼⵍⵉⴷ
audition: ⵜⴰⵙⵍⴰ
author: ⴰⵎⵙⴽⴰⵔ
authorities: ⵉⴷⴰⴱⵓⵜⵏ
authority: ⴰⴷⴰⴱⵓ
authors: ⵉⵎⵙⴽⴰⵔⵏ
automatic: ⴰⵡⵓⵔⵎⴰⵏ
automatically: ⵙ ⵓⵡⵓⵔⵎⴰⵏ
autumn: ⴰⵎⵡⴰⵏ
auxiliary: ⴰⵎⴰⵡⴰⵙ
available: ⴰⵢⵍⵍⴰⵏ
awareness: ⴰⴽⴰⵣ
back: ⵜⴰⴷⴰⵡⵜ
background: ⵜⴰⴼⵔⴳⵯⵏⵉⵜ
backgrounds: ⵜⵉⴼⵔⴳⵯⵏⵉⵢⵉⵏ
bacteria: ⴰⴱⴰⴽⵜⵉⵔⵢⴰ
bacteria: ⴰⴱⴰⴽⵜⵉⵔⵢⴰ
bad: ⴳⴰⵔ
bag: ⵜⴰⵛⵛⴽⴰⵕⵜ
balance: ⴰⵎⵢⴰⵙ
ball: ⵜⴰⵡⵊⵊⴰ
bank: ⴰⴱⴰⵏⴽ
bar: ⴰⴼⴳⴳⴰⴳ
barber: ⴰⵃⴼⴼⴰⴼ
barn: ⵜⴰⴳⵔⵓⵔⵜ
base: ⵜⴰⴷⴰⵙⵉⵍⵜ
basic: ⴰⴷⴰⵙⵉⵍ
basics: ⵉⴷⴰⵙⵉⵍⵏ
basis: ⴰⴷⴰⵙⵉⵍ
bathroom: ⴰⵔⴰⴷⴰⴱ
battery: ⴰⴱⴰⵜⵔⵉ
bay: ⴰⵙⵍⴰⵍⵍⵓ
beach: ⵜⴰⵖⴰⵔⵜ ⵏ ⵢⵉⵍⵍ
bean-shaped: ⵜⴰⵡⵉⵍⴰ ⵏ ⵢⵉⴱⴰⵡⵏ
bear: ⴰⴱⵓⴱⴱⴰⵣ
beard: ⵜⴰⵎⴰⵔⵜ
beautiful: ⵉⵥⵉⵍⵏ
because: ⴰⵛⴽⵓ
bed: ⵓⵙⵓ
bedroom: ⴰⵃⴰⵏⵓ ⵏ ⵜⴳⵓⵏⵉ
bedrooms: ⵉⵃⵓⵏⴰ ⵏ ⵜⴳⵓⵏⵉ
been: ⵢⴰⴷⵍⵍⵉ
before: ⴷⴰⵜ
beginner: ⴰⵎⵙⵙⵏⵜⵉ
beginners: ⵉⵎⵙⵙⵏⵜⵉⵢⵏ
behavior: ⴰⵎⵓⴳⴳⵉ
behaviors: ⵉⵎⵓⴳⴳⵉⵜⵏ
behaviour: ⴰⵎⵓⴳⴳⵉ
behaviours: ⵉⵎⵓⴳⴳⵉⵜⵏ
behind: ⴷⴼⴼⵉⵔ
benefit: ⵜⴰⵍⵓⵎⵎⵉⵥⵜ
benefits: ⵜⵉⵍⵓⵎⵎⵉⵥⵉⵏ
berber: ⵜⴰⵎⴰⵣⵉⵖⵜ
best: ⵜⵓⴼⵓⵜ
better: ⵢⵓⴼⵏ
between: ⴳⵔ
beyond: ⴹⴰⵔⴰⵜ
bicycle: ⴰⵣⵍⴰⵍⴰⵎ
big: ⴰⵎⵇⵔⴰⵏ
bigger: ⴰⵎⵇⵔⴰⵏ
binary: ⵉⵎⵉⵙⵉⵏ
biochemical: ⴰⴷⵔⴽⵔⵓⵔⴰⵏ
biology: ⵜⴰⵙⵏⵓⴷⵔⵜ
bipedal: ⴰⵙⵏⴹⴰⵕ
bipedalism: ⵜⴰⵙⵏⴹⴰⵕⵜ
bird: ⴰⴳⴹⵉⴹ
birds: ⵉⴳⴹⴰⴹ
birth: ⵜⴰⵍⴰⵍⵉⵜ
bitter: ⴰⵎⵔⵥⴰⴳⵓ
black: ⴰⴱⵔⴽⴰⵏ
blind: ⴰⴷⵔⵖⴰⵍ
block: ⴰⵣⵏⵣⵉⵖ
blood: ⵉⴷⴰⵎⵎⵏ
blue: ⴰⵥⵕⵡⴰⵍ
blueprints: ⵉⵖⴰⵡⴰⵙⵏ
body: ⵜⴰⴼⴽⴽⴰ
bone marrow: ⴰⴷⵉⴼ
book: ⴰⴷⵍⵉⵙ
books: ⵉⴷⵍⵉⵙⵏ
boolean: ⴰⴱⵓⵍⵢⴰⵏ
booleans: ⵉⴱⵓⵍⵢⴰⵏⵏ
border: ⵉⵡⵜⵜⴰ
both: ⵙ ⵙⵉⵏ
bottom: ⵉⵣⴷⴷⴰⵔ
boundary: ⴰⵡⵜⵜⵓ
bowl: ⴰⴳⵔⴰ
bowls: ⴰⴳⵔⵉⵡⵏ
box: ⵜⴰⴼⵏⵉⵇⵜ
boy: ⴰⵔⴱⴰ
boys: ⵉⵔⴱⴰⵏ
brain: ⴰⵏⵍⵉ
branch: ⵉⵥⵍⵉ
branches: ⵉⵥⵍⵉⵜⵏ
brand: ⵜⴰⵎⴰⵜⴰⵔⵜ
brave: ⴰⵏⴱⵖⵓⵙ
bread: ⴰⵖⵔⵓⵎ
breakfast: ⴰⵖⵓⵊⵊⵔ
breeze: ⴰⵣⵓⵣⵡⵓ
bride: ⵜⵉⵙⵍⵉⵜ
bridegroom: ⵉⵙⵍⵉ
bridge: ⵜⵉⵍⴳⴳⵯⵉⵜ
brother: ⵓⵎⴰ
brothers: ⴰⵢⵜⵎⴰⵜⵏ
brothership: ⵜⴰⵡⵎⴰⵜ
browser: ⵉⵎⵉⵏⵉⴳ
browsers: ⵉⵎⵉⵏⵉⴳⵏ
bucket: ⴰⴳⴰ
building: ⵜⵉⵥⴽⵉ
built-in: ⴰⵎⴰⴷⴰⴼ
business: ⴰⵎⴰⵀⵉⵍ
businessman: ⴱⴰⴱ ⵏ ⵜⵡⵓⵔⵉⵡⵉⵏ
but: ⵎⴰⵛⴰ
by: ⵙ
calculation: ⴰⵙⵉⴹⵏ
calculations: ⵉⵙⵉⴹⴰⵏ
calculus: ⴰⵙⵉⴹⵏ
caller: ⴰⵎⵍⴰⵖⵉ
camel: ⴰⵍⵖⵎ
canada: ⴽⴰⵏⴰⴷⴰ
capable: ⵉⵣⵎⵔ
capacity: ⴰⴽⵜⵜⵓⵔ
capital: ⵜⴰⵎⴰⵥⵓⵏⵜ
capitalism: ⵜⴰⵥⵕⴷⴳⴰⵔⵜ
car: ⵜⵉⵀⵉⵔⵉⵜ
carbon: ⴰⴽⴰⵔⴱⵓⵏ
card: ⵜⴰⴽⴰⵔⴹⴰ
carpet: ⵜⴰⴽⴹⵉⴼⵜ
cars: ⵜⵉⵀⵉⵔⵉⵜⵉⵏ
cartoon: ⵓⵏⵓⵖ ⵉⵜⵜⵎⵓⵙⵙⵓⵏ
cartoons: ⵓⵏⵓⵖⵏ ⵉⵜⵜⵎⵓⵙⵙⵓⵏ
case: ⴰⴷⴷⴰⴷ
cases: ⴰⴷⴷⴰⴷⵏ
castle: ⵉⵖⵔⵎ
cat: ⴰⵎⴰⵛⵛⵓ
categories: ⵜⴰⴳⴳⴰⵢⵉⵏ
category: ⵜⴰⴳⴳⴰⵢⵜ
cats: ⵉⵎⵓⵛⵛⴰ
cattle: ⴰⵛⵜⴰⵍ
cause: ⴰⵙⵔⴰⴳ
cave: ⵉⴼⵔⵉ
caves: ⵉⴼⵔⴰⵏ
celestial: ⴰⴳⵏⵏⴰⵢ
cell: ⵜⴰⵖⵔⴰⵙⵜ
cells: ⵜⵉⵖⵔⴰⵙⵉⵏ
cellular: ⴰⵖⵔⴰⵙⴰⵏ
center: ⴰⵎⵎⴰⵙ
centers: ⴰⵎⵎⴰⵙⵏ
central: ⴰⵏⴰⵎⵎⴰⵙ
centuries: ⵜⵉⵙⵓⵜⵉⵏ
century: ⵜⴰⵊⵕⵎⴰ
ceremonies: ⵜⵉⴼⵓⴳⵍⵉⵡⵉⵏ
ceremony: ⵜⴰⴼⵓⴳⵍⴰ
certain: ⴽⵔⴰ ⵏ
certainly: ⵙ ⵓⵍⴽⴰⵏ
certificate: ⴰⵙⵍⴽⵉⵏ
certificates: ⵉⵙⵍⴽⵉⵏⵏ
chain: ⴰⵙⴷⴷⵉ
chains: ⵉⵙⴷⴷⵉⵜⵏ
chair: ⴰⵙⵖⵉⵎ
chairs: ⵉⵙⵖⵉⵎⵏ
challenge: ⴰⵏⴰⵥⴰⵕ
challenges: ⵉⵏⴰⵥⴰⵕⵏ
change: ⴰⵙⵏⴼⵍ
changing: ⴰⵙⵏⴼⵍ
channel: ⵜⴰⴱⴰⴷⵓⵜ
channels: ⵜⵉⴱⴰⴷⵓⵜⵉⵏ
chapter: ⵜⴰⴳⵟⵟⵓⵎⵜ
chapter: ⵜⴰⴳⵣⵣⵓⵎⵜ
chapters: ⵜⵉⴳⵟⵟⵓⵎⵉⵏ
character: ⴰⵙⴽⴽⵉⵍ
characteristic: ⵜⴰⴼⵔⵉⵙⵜ
characteristics: ⵜⵉⴼⵔⵉⵙⵉⵏ
characters: ⵉⵙⴽⴽⵉⵍⵏ
charge: ⵜⴰⵙⴽⵜⵔⵜ
charger: ⴰⵎⵙⴽⵜⵔ
charging: ⴰⵙⴽⵜⵔ
cheek: ⴰⵎⴰⴷⵍ
chemical: ⴰⴽⵔⵓⵔⴰⵏ
chemistry: ⵜⴰⴽⵔⵓⵔⴰ
chess: ⵜⵉⴷⴷⴰⵙ
chest: ⵉⴷⵎⴰⵔⵏ
child: ⴰⵣⵣⴰⵏ
children: ⵜⴰⵔⵡⴰ
chin: ⵜⴰⵎⴰⵔⵜ
choice: ⴰⵙⵜⴰⵢ
choices: ⵉⵙⵜⴰⵢⵏ
cinema: ⵙⵙⵉⵏⵉⵎⴰ
circle: ⵜⴰⵡⵔⴻⵔⵔⴰⵢⵜ
circles: ⵜⵉⵡⵔⴻⵔⵔⴰⵢⵉⵏ
circuit: ⴰⵙⵓⵏⵏⴰⴹ
circuits: ⵉⵙⵓⵏⵏⴰⴹⵏ
circumstance: ⵜⴰⵎⵙⵓⵜⵍⵜ
circumstances: ⵜⴰⵎⵙⵓⵜⴰⵍ
cities: ⵜⵉⵖⵔⵎⵉⵏ
citizen: ⴰⵏⴰⵎⵓⵔ
citizens: ⵉⵏⴰⵎⵓⵔⵏ
city: ⵜⴰⵎⴷⵉⵏⵜ
civilization: ⵜⴰⵖⵔⵎⴰ
civilizations: ⵜⵉⵖⵔⵎⴰⵉⵡⵉⵏ
class: ⴰⵙⵎⵉⵍ
classes: ⵉⵙⵎⵉⵍⵏ
classification: ⴰⵙⵉⵙⵎⵍ
clean: ⴰⵣⴷⴳⴰⵏ
climate: ⴰⵏⴳⵉⴳⵜ
clinic: ⵜⴰⵙⴷⵓⵙⵉⵜ
clothes: ⵜⵉⵎⵍⵙⴰ
cloud: ⴰⵎⴷⵍⵓ
clouds: ⵉⵎⴷⵍⴰ
cluster: ⵜⴰⵥⵕⵎⵜ
clusters: ⵜⵉⵥⵕⵎⵉⵏ
coast: ⴰⴼⵜⴰⵙ
code: ⵜⴰⵏⴳⴰⵍⵜ
coding: ⴰⵙⵏⵉⴳⵍ
cold (adj): ⴰⵙⵎⵎⴰⴹ
cold (n): ⴰⵙⵎⵎⵉⴹ
collection (action): ⵜⵉⴳⵔⵉ
collection: ⵜⴰⵍⴽⵏⵙⵉⵜ
collections: ⵜⵉⵍⴽⵏⵙⵉⵢⵉⵏ
collective: ⴰⵎⴳⵔⴰⵡ
college: ⵜⴰⵖⵉⵡⴰⵏⵜ
collision: ⴰⵏⴳⴰⵙ
collisions: ⵉⵏⴳⴰⵙⵏ
collustrum: ⴰⴷⵖⵙ
colon: ⵙⵏⴰⵜ ⵜⵇⵉⴼⴰ
color: ⴰⴽⵍⵓ
colors: ⵉⴽⵯⵍⴰⵏin
column: ⵜⴰⵏⵏⴰⵍⵜ
combination: ⵜⴰⵙⵓⴷⴷⵓⵙⵜ
combinations: ⵜⵉⵙⵓⴷⴷⵓⵙⵉⵏ
combine: ⵍⴽⵙ
comet: ⵜⴰⵎⵙⵔⵉⵡⵜ
comets: ⵜⵉⵎⵙⵔⵉⵡⵉⵏ
comma: ⵜⵉⵙⴽⵔⵜ
commas: ⵜⵉⵙⴽⵔⵉⵏ
command: ⴰⵏⴰⴹ
commands: ⴰⵏⴰⴹⵏ
comment: ⴰⵖⴼⴰⵡⴰⵍ
comments: ⵉⵖⴼⴰⵡⴰⵍⵏ
common: ⵉⵙⵙⴰⵔⵏ
commonly: ⵉⵜⵜⵓⵎⵢⴰⵔ
communication: ⴰⵎⵢⴰⵡⴰⴹ
communities: ⴰⵎⵓⵏⵏ
community: ⴰⵎⵓⵏ
companies: ⵜⵉⵎⵙⵙⵓⵔⵉⵏ
company: ⵜⴰⵎⵙⵙⵓⵔⵜ
comparison: ⴰⵙⵎⵣⴰⵣⴰⵍ
comparisons: ⵉⵙⵎⵣⴰⵣⴰⵍⵏ
compatible: ⴰⵎⵙⴰⵙⴰⵢ
competence: ⵜⴰⵙⵓⴳⵔⵜ
competences: ⵜⵉⵙⵓⴳⴰⵔ
competent: ⴰⵎⵙⵓⴳⵔ
competition: ⴰⵎⵣⵉⵣⵡⵔ
compiler: ⴰⵙⴼⵙⴰⵢ
complete: ⵓⵎⵎⵉⴷ
completely: ⵙ ⵜⵉⵎⵎⴰⴷ
complex: ⵓⴷⴷⵉⵙ
compliment: ⵜⵓⵍⵖⴰ
compliments: ⵜⵓⵍⵖⵉⵡⵉⵏ
component: ⵉⵙⴳⵔ
components: ⵉⵙⴳⵔⴰⵏ
composed: ⵓⴷⴷⵉⵙ
composition: ⴰⵙⵓⴷⴷⵙ
composition: ⵜⵓⴷⴷⵙⴰ
compositor: ⴰⵎⵙⵓⴷⴷⵙ
compound: ⵓⴷⴷⵉⵙ
compounds: ⵓⴷⴷⵉⵙⵏ
comprehensive: ⵓⵙⵎⵉⴷ
compression: ⵜⴰⵔⵏⵓⵙⵙⴷⴰ
computational: ⴰⵙⵏⵙⵍⴽⴰⵎ
computer-science: ⵜⴰⵙⵏⵙⵍⴽⵉⵎⵜ
computer: ⴰⵎⵙⵙⵉⴹⵏ
computers: ⵉⵎⵙⵙⵉⴹⵏⵏ
concentration: ⴰⵏⵏⵓⵎⵎⵙ
concept: ⴰⵔⵎⵎⵓⵙ
concepts: ⵉⵔⵎⵎⵓⵙⵏ
conceptualization: ⴰⵙⵔⵎⵎⵓⵙ
concern: ⴰⵏⵣⴳⵓⵎ
conclusion: ⴰⵙⴼⵍⵓ
condition: ⵜⴰⴼⴰⴷⴰ
conditional: ⴰⴼⴰⴷⴰⵏ
conditionals: ⵉⴼⴰⴷⴰⵏⵏ
conditions: ⵜⵉⴼⴰⴷⵉⵡⵉⵏ
conduction: ⴰⵡⵡⴰⵢ
conference: ⵜⵉⵏⴰⵡⵜ
configuration: ⴰⵙⵡⵍ
conflict: ⴰⵎⵏⵣⴰⵖ
connection: ⵜⵓⵇⵇⵏⴰ
conscience: ⴰⴼⵔⴰⴽ
consciousness: ⴰⴼⵔⴰⴽ
consecutive: ⵓⴹⴼⵉⵕ
conservation: ⴰⵏⵏⴽⵛⴰⴷ
console: ⵜⴰⴷⵉⵡⵏⵜ
constant: ⵉⵎⵣⴳⵉ
constantly: ⵙ ⵜⵙⵓⵍⵜ
constellation: ⵜⴰⵎⵜⵉⵡⴳⵜ
constellations: ⵜⵉⵎⵜⵉⵡⴳⵉⵏ
constituent: ⵉⵙⴳⵔ
constituents: ⵉⵙⴳⴰⵔ
construction: ⵜⵉⵥⴽⵉ
consumer: ⴰⵏⵙⵎⵓⵔ
consumption: ⴰⵙⵙⵎⴰⵔ
container: ⴰⵙⴰⵎⵓ
containers: ⵉⵙⴰⵎⵓⵜⵏ
contains: ⵢⵓⵎⴰ
contemporaneity: ⵜⴰⵎⵉⵔⴰⵏⵜ
contempt: ⵜⴰⵍⴽⴽⴰⵡⵜ
content: ⵜⵓⵎⴰⵢⵜ
contents: ⵜⵓⵎⴰⵢⵉⵏ
context: ⴰⵙⴰⵜⴰⵍ
contexts: ⵉⵙⴰⵜⴰⵍⵏ
continent: ⴰⵎⵏⵥⴰⵡ
continents: ⵉⵎⵏⵥⴰⵡⵏ
control: ⴰⵏⴱⴰⴹ
convert: ⵙⵏⴼⵍⵖⴰ
converts: ⵉⵏⴼⵍⵖⴰ
convolutional: ⴰⵎⵙⵉⵙⴰⵏ
cool: ⵉⵥⵉⵍⵏ
copy: ⵙⵙⵏⵖⵍ
core: ⴰⵖⵢⴰⵢ
corn: ⴰⵇⵇⴰⵢⵏ
correct: ⵉⵖⵜⴰⵏ
correction: ⴰⵖⵜⴰⵢ
corrections: ⵉⵖⵜⴰⵢⵏ
correctly: ⵙ ⵓⵖⵜⴰⵢ
cosmology: ⵜⴰⵙⵏⵎⵖⵔⴰⴷⵜ
cosmos: ⴰⵎⵖⵔⴰⴷ
coulomb: ⴽⵓⵍⵓⵎ
countless: ⵡⴰⵔ ⴰⵙⵉⴹⵏ
countries: ⵜⵉⵎⵉⵣⴰⵔ
country: ⵜⴰⵎⴰⵣⵉⵔⵜ
couple: ⵜⴰⵢⵓⴳⴰ
course: ⵜⴰⵙⵓⵜⵍⵜ
courses: ⵜⵉⵙⵓⵜⴰⵍ
cow: ⵜⴰⴼⵓⵏⴰⵙⵜ
crazy: ⴰⵏⴰⴼⴰⵍ
creation: ⴰⵙⵏⵓⵍⴼⵓ
creative: ⴰⵎⵙⵏⵓⵍⴼⵓ
creativity: ⴰⵙⵏⴼⵍⵓⵍ
creature: ⵜⴰⵖⵏⵏⴰⵡⵜ
creatures: ⵜⵉⵖⵏⵏⴰⵡⵉⵏ
critical: ⴰⵣⵖⵏⴰⵏ
criticism: ⴰⵣⵖⴰⵏ
criticizable: ⵓⵣⵖⵉⵏ
crow: ⴰⴳⵔⴼⵉⵡ
crucial: ⴰⵎⵖⵜⴰⵙ
culture: ⵜⴰⴷⵍⵙⴰ
curds: ⵉⴽⴽⵉⵍ
currency: ⴰⵇⴰⵕⵉⴹ
current: ⴰⵎⵣⴰⵣ
cycle: ⵜⵓⵏⵓⴹⵜ
cytoplasm: ⴰⵙⵉⵜⵓⴼⵍⴰⵥⵎ
daily: ⴰⴽⵓⵢⴰⵙⵙ
dam: ⵓⴳⴳⵓⴳ
dark: ⴰⵎⴰⵍⵍⵙ
darkest: ⴰⵎⴰⵍⵍⵙ ⴰⴽⴽⵯ
darkness: ⵜⵉⵍⵍⴰⵙ
data: ⵉⵙⴼⴽⴰ
dating: ⵜⴰⵙⵙⴰⴽⵓⴷⵜ
day: ⴰⵙⵙ
days: ⵓⵙⵙⴰⵏ
daytime: ⴰⵣⴰⵍ
death: ⵜⴰⵎⵜⵜⴰⵏⵜ
decade: ⵜⴰⵎⵔⴰⵡⴰⵏⵜ
decimal: ⴰⵏⵎⵔⴰⵡ
decision: ⵜⴰⵖⵜⴰⵙⵜ
decisions: ⵜⵉⵖⵜⴰⵙⵉⵏ
decoding: ⴰⴽⵙⵏⴳⵍ
deep: ⵉⵖⴱⵉⵏ
deeper: ⵉⵏⵖⴱⵉ
defeat: ⴰⵜⵜⵡⴰⵔⵏⵓ
defender: ⴰⵏⵎⵣⴰⵖ
defenders: ⵉⵏⵎⵣⴰⵖⵏ
define: ⵙⵏⵎⵍ
definition: ⴰⵙⵏⵎⵍ
definitely: ⵏⵏⵉⵛⴰⵏ
deform: ⵙⵍⵓⵅⵛⵓ
deform: ⵙⵎⵎⵊⴳⵔ
degree: ⵜⴰⵙⴽⵯⴼⵍⵜ
demand: ⴰⵙⵓⵜⵔ
demands: ⵉⵙⵓⵜⴰⵔ
density: ⵜⵉⵏⵥⵥⵉ
derivability: ⵜⴰⵣⵎⵔⵡⴰⴼⵓⵖⵜ
derivation: ⵜⴰⵡⴰⴼⵓⵖⵜ
derived: ⴰⵏⴰⴼⵓⵖ
descriptive: ⵓⴳⵍⵉⵎ
desert: ⵜⴰⵏⵣⵔⵓⴼⵜ
deserts: ⵜⵉⵏⵣⵔⵓⴼⵉⵏ
design: ⴰⵙⵖⵉⵡⵙ
designed: ⵜⵜⵓⵙⵖⵉⵡⵙ
designing: ⴰⵙⵖⵉⵡⵙ
desk: ⴰⵙⵉⵔⴰ
desktop: ⴰⴼⵍⵍⴰⵔⴰ
despite: ⵎⵇⵇⴰⵔ
destination: ⴰⵡⵜⵜⴰⵙ
destinations: ⵉⵡⵜⵜⴰⵙⵏ
destruction: ⴰⵔⴷⴰⵍ
detail: ⴰⴼⵔⴰⵔⴰⵢ
details: ⵉⴼⵔⴰⵔⴰⵢⵏ
detection: ⴰⵍⴷⴰⵢ
detector: ⴰⵎⵙⴷⵔⴳⵏ
determination: ⴰⵙⵓⵜⵜⵓ
developer: ⴰⵎⵙⵏⴼⵍⵉ
developers: ⵉⵎⵙⵏⴼⵍⵉⵢⵏ
developing: ⴰⵙⵏⴼⵍⵉ
development: ⵜⴰⵏⴼⵍⵉⵜ
device: ⴰⵍⵍⴰⵍ
devices: ⴰⵍⵍⴰⵍⵏ
diabetic: ⴰⵎⴰⴹⵓⵏ ⵏ ⵓⵙⴽⴽⵯⴰⵔ
diabetics: ⵉⵎⴰⴹⵓⵏⵏ ⵏ ⵓⵙⴽⴽⵯⴰⵔ
diagnostic: ⴰⴽⴰⵣ
diagram: ⴰⵎⵙⴽⴰⵏ
diagrams: ⵉⵎⵙⴽⴰⵏⵏ
dictionaries: ⵉⴳⵣⴰⵡⴰⵍⵏ
dictionary: ⴰⴳⵣⴰⵡⴰⵍ
difference: ⴰⵎⵣⴰⵔⴰⵢ
different: ⵉⵎⵣⴰⵔⴰⵢⵏ
differential: ⴰⵎⵣⵉⵔⵢⴰⵏ
differentially: ⵙ ⵓⵎⵣⵉⵔⵢ
differently: ⵙ ⵓⵎⵣⴰⵔⴰⵢ
difficult: ⵉⵎⵔⴰⵏ
difficulty: ⵜⴰⵎⴰⵔⴰ
diffusion: ⵜⴰⵏⵣⵡⵉⵜ
digit: ⴰⵣⵡⵉⵍ
digits: ⵉⵣⵡⵉⵍⵏ
dignity: ⴰⴳⵎⵎⵉⵔ
dimension: ⵜⴰⵙⴽⵜⴰ
dimensional: ⴰⵙⴽⵜⴰⵏ
dimensional: ⴰⵙⴽⵜⴰⵏ
dimensions: ⵜⵉⵙⴽⵜⴰⵡⵉⵏ
dinner: ⵉⵎⵏⵙⵉ
dioxide: ⴰⵙⵉⵏⵓⴽⵙⵉⴷ
direct: ⵓⵙⵔⵉⴷ
directly: ⵙ ⵡⵓⵙⵔⵉⴷ
directories: ⵉⴽⴰⵔⴰⵎⵏ
directory: ⴰⴽⴰⵔⴰⵎ
discourse: ⴰⵎⵙⴰⵡⴰⵍ
discovery: ⴰⵙⴼⵓⴽⴽⵔ
discussion: ⴰⵎⵙⴳⴷⴰⵍ
discussions: ⵉⵎⵙⴳⴷⴰⵍⵏ
disease: ⴰⵟⵟⴰⵏ
diseases: ⴰⵟⵟⴰⵏⵏ
disorder: ⴰⵎⵔⵡⵉ
disorders: ⵉⵎⵔⵡⴰⵢⵏ
disposition: ⴰⵎⵙⵉⵣⵡⵔ
distance: ⴰⵣⴰⵔⵓ
distances: ⵉⵣⴰⵔⵓⵜⵏ
distant: ⴰⵣⴰⵔⵓ
distants: ⵉⵣⴰⵔⵓⵜⵏ
distinction: ⴰⵙⵏⴼⵔⵓ
distinctive: ⵉⵎⵙⴼⵔⵓ
distortion: ⴰⵎⵎⵊⴳⵔ
distribution: ⴰⴱⵟⵟⵓ
ditch: ⴰⵛⴱⴰⵕ
diversity: ⴰⵎⵢⴰⵏⴰⵡ
dividend: ⴰⵎⵜⵜⵡⴰⴱⴹⵓ
division: ⵜⵉⴱⴹⵉⵜ
divisor: ⴰⵏⴱⴹⴰⵢ
doctor: ⴰⵎⵙⴳⵏⴰⴼ
document: ⵜⴰⵏⵜⴰⵎⵜ
documentation: ⴰⵙⵏⵜⵎ
documented: ⵓⵏⵜⵉⵎ
documents: ⵜⵉⵏⵜⴰⵎⵉⵏ
dog: ⴰⵢⴷⵉ
dogs: ⵉⵢⴷⴰⵏ
donkey: ⴰⵖⵢⵓⵍ
door: ⵜⴰⴳⴳⵓⵔⵜ
doorbell: ⴰⵙⵔⵙⴰⵔ
doors: ⵜⵉⵡⵡⵓⵔⴰ
downstream: ⴰⵏⵏⵖⵍ
dream: ⵜⴰⵡⴰⵔⴳⵉⵜ
dress: ⵜⴰⵔⵙⵡⴰⵢⵜ
drop: ⵜⵉⵎⵇⵇⵉⵜ
drought: ⵜⵉⵣⵡⵉ
duration: ⵜⴰⵏⵣⴰⴳⵜ
during: ⴳ ⵜⵉⵣⵉ
dust: ⴰⴳⴹⵕⵓⵕ
duty: ⵜⵓⵖⵓⵏⵜ
dwarf: ⴰⴳⵣⵣⴰⵢⵍⵓ
dwarfs: ⵉⴳⵣⵣⴰⵢⵍⵓⵜⵏ
dynamic: ⴰⵎⵓⵙⵙⴰⵏ
each: ⴽⵓ
eagle: ⵉⴳⵉⴷⵔ
ear: ⴰⵎⵥⵥⵓⵖ
early: ⵣⵉⴽⴽ
earphone: ⵜⵉⵙⵉⵙⵍⵉⵜ
ears: ⵉⵎⵣⴳⴰⵏ
earth: ⴰⴽⴰⵍ
earthquake: ⴰⵏⴷⵓⴷⵉ ⵏ ⵡⴰⴽⴰⵍ
earthquakes: ⵉⵏⴷⵓⴷⵉⵢⵏ ⵏ ⵡⴰⴽⴰⵍ
easily: ⵙ ⵜⵏⵀⵍⵉ
east: ⴰⴳⵎⵓⴹ
easy: ⵓⵏⵀⵉⵍ
eclipse: ⴰⵜⵔⵎⵙ
eclipses: ⵉⵜⵔⵎⵙⵏ
economics: ⵜⴰⴷⵎⵙⴰ
economy: ⵜⴰⴷⵎⵙⴰ
edge: ⵜⴰⵎⴰ
edition: ⵜⴰⵥⵕⵉⴳⵜ
editor: ⴰⵎⵥⵕⴰⴳ
education: ⴰⵙⴳⵎⵉ
educational: ⴰⵙⴳⵎⴰⵏ
effect: ⵜⴰⵣⵔⵉⵔⵜ
effective: ⵉⵎⵕⵡⵉ
effectively: ⵙ ⵜⵕⵡⵉ
effects: ⵜⵉⵣⵔⴰⵔⵉⵏ
efficiency: ⵜⵉⵕⵡⵉ
efficient: ⵉⵎⵕⵡⵉ
efficiently: ⵙ ⵜⵉⵕⵡⵉ
effort: ⵉⵎⵎⵉⵔ
effortlessly: ⵎⵉⵏ ⵉⵎⵎⵉⵔ
efforts: ⵉⵎⵎⵉⵔⵏ
egg: ⵜⴰⴳⵍⴰⵢⵜ
eight: ⵜⴰⵎ
eighty: ⵜⴰⵎⵔⴰⵡ
elbow: ⵜⵉⵖⵎⵔⵜ
election: ⵜⴰⴼⵔⴰⵏⵜ
elections: ⵜⵉⴼⵔⴰⵏⵉⵏ
electric: ⴰⵎⵥⵥⴰⵕⵓⵕ
electrical: ⴰⵎⵥⵥⴰⵕⵓⵕ
electricity: ⴰⵥⴰⵕⵓⵕ
electromagnetic: ⴰⵍⵉⴽⵜⵕⵓⴷⴽⴰⵔ
electromagnetic: ⴰⵍⵉⴽⵜⵕⵓⵎⵖⵏⴰⵟⵉⵙ
electromagnetism: ⵜⴰⵍⵉⴽⵜⵕⵓⴷⴽⵉⵔⵜ
electron: ⴰⵍⵉⴽⵜⵕⵓⵏ
electrons: ⵉⵍⵉⴽⵜⵕⵓⵏⵏ
elegant: ⴰⵎⵀⵢⴰⵔ
element: ⴰⴼⵔⴷⵉⵙ
elements: ⵉⴼⵔⴷⵉⵙⵏ
elimination: ⴰⵙⵉⵜⵜⵉ
elision: ⵜⴰⴽⵙⵍⵎⵎⴰⵙⵜ
else: ⵢⴰⴹⵏ
email: ⵜⴰⵙⴰⵡⴰⵢⵜ ⵜⴰⵍⵉⴽⵟⵕⵓⵏⵉⵜ
emission: ⴰⵙⵉⴼⴹ
emissions: ⵉⵙⵉⴼⵉⴹⵏ
emitter: ⴰⵎⴰⵣⴰⵏ
emitters: ⵉⵎⴰⵣⴰⵏⵏ
emotion: ⵜⵓⴼⵔⴰⵢⵜ
emotions: ⵜⵓⴼⵔⴰⵢⵉⵏ
employment: ⴰⵙⵎⴰⵀⵍ
encapsulation: ⴰⵜⵜⴰⵍ
encoding: ⴰⵙⵏⴳⵍ
encouragement: ⴰⵙⵙⴱⵖⵙ
end: ⵜⵉⴳⵉⵔⴰ
endless: ⵜⴰⵔⴳⵉⵔⴰ
enemy: ⴰⵛⵏⴳⵓ
energies: ⵜⵉⴼⴰⵙⴰⵜⵉⵏ
energy: ⵜⴰⴼⴰⵙⴰ
engine: ⴰⵏⵙⵎⴰⵙⵙⵓ
engineer: ⴰⵎⵜⵡⴰⵍ
engineering: ⴰⵜⵡⴰⵍ
engines: ⵉⵏⵙⵎⵓⵙⵙⴰ
enigma: ⵜⵉⵏⵥⵥⵕⵜ
enough: ⵢⵓⴷⴰⵏ
entities: ⵉⵢⵓⵏⵏ
entity: ⴰⵢⵓⵏ
enemies: ⵉⵛⵏⴳⴰ
entropy: ⴰⵏⵜⵓⵜⵔ
environment: ⵜⴰⵡⵏⵏⴰⴹⵜ
episode: ⵜⴰⵅⵔⵙⵜ
episodes: ⵜⵉⵅⵔⵙⵉⵏ
epithelium: ⵜⴰⴼⵍⴷⵔⵖⵜ
equation: ⵜⴰⴳⴷⴰ
equations: ⵜⴰⴳⴷⵉⵡⵉⵏ
equivalence: ⵜⴰⴳⴷⴰⵣⴰⵍⵜ
equivalent: ⴰⵎⴳⴷⴰⵣⴰⵍ
error: ⴰⵣⴳⴰⵍ
errors: ⵉⵣⴳⴰⵍⵏ
escape: ⵔⵡⵍ
especially: ⵙⵍⴰⵡⴰⵏ
essence: ⵜⵓⵎⴰⵙⵜ
essential: ⴰⵏⵓⵎⴰⵙ
etc: ⴰⵜⴳ
etymology: ⵜⴰⵙⵏⴰⵥⵖⵓⵕⵜ
evaluation: ⴰⵙⵓⵜⴳ
event: ⵜⴰⵎⵙⴰⵔⵜ
events: ⵜⵉⵎⵙⴰⵔⵉⵏ
every: ⴽⵓ
everyday: ⴽⵔⴰⵢⴳⴰⵜⵜ ⴰⵙⵙ
everyone: ⴽⵓ ⵢⴰⵏ
everything: ⴽⵔⴰⵢⴳⴰⵜⵜ ⵜⴰⵖⴰⵡⵙⴰ
evidence: ⴰⵏⵥⴰ
evidences: ⴰⵏⵥⴰⵜⵏ
evolution: ⵜⴰⵣⵣⵉⴳⵣⵜ
exact: ⵏⵉⵜ
exactly: ⵏⵏⵉⵛⴰⵏ
exam: ⵉⵔⵉⵎ
examination: ⴰⵣⵣⵔⴰⵢ
examinations: ⵉⵣⵣⵔⴰⵢⵏ
example: ⴰⵎⴷⵢⴰ
examples: ⵉⵎⴷⵢⴰⵜⵏ
exams: ⵉⵔⵉⵎⵏ
excellent: ⴰⵏⵓⴼⵍⴰⵢ
except: ⵙⵍⵉⴷ
exception: ⴰⵙⵍⵉⴷ
exceptions: ⵉⵙⵍⵉⴷⵏ
exchange: ⴰⵙⵎⵎⵙⴽⵍ
exciting: ⵉⴼⵊⵊⵉⵊⵏ
execution: ⴰⵣⵣⴳⵉⵔ
exercise: ⴰⵍⴰⵖⵎⵓ
exercises: ⵉⵍⵓⵖⵎⴰ
existence: ⵜⵉⵍⵍⵉⵜ
expected: ⵜⵜⵓⴹⴽⴰⴹ
experience: ⵜⵓⵔⵎⵉⵜ
experiences: ⵜⵓⵔⵎⵉⵢⵉⵏ
experiment: ⵜⵓⵔⵎⵉⵜ
experimentation: ⴰⵔⴰⵎ
experimental: ⴰⵏⴰⵔⴰⵎ
explanation: ⴰⵙⵙⴼⵔⵓ
exploitation: ⴰⵙⵎⴰⵀⵍ
exploration: ⵉⵏⵉⴳ
explorations: ⵉⵏⵉⴳⵏ
exploring: ⵉⵏⵉⴳ
exponential: ⴰⵙⵓⵣⵎⵉⵔ
expression: ⵜⴰⵏⴼⴰⵍⵉⵜ
expressions: ⵜⵉⵏⴼⴰⵍⵉⵢⵉⵏ
extended: ⵉⵜⵜⵓⵥⵥⴰⵍⵏ
extension: ⴰⵙⵉⵖⵣⴼ
extracting: ⵜⵓⵙⵙⴼⴰ
europe: ⵜⵓⵔⵓⴼⵜ
eye: ⵜⵉⵟⵟ
eyes: ⴰⵍⵍⵏ
eyesight: ⵉⵥⵕⵉ
face: ⵓⴷⵎ
facebook: ⴼⴰⵢⵙⴱⵓⴽ
faculty: ⵜⴰⵖⵉⵡⴰⵏⵜ
fact: ⵉⵎⵊⵕⵉ
factor: ⴰⵎⵙⴽⴰⵔ
factors: ⵉⵎⵙⴽⴰⵔⵏ
facts: ⵉⵎⵊⵕⵉⵜⵏ
fake: ⵓⵔⵊⵉⵏ
false: ⵓⵣⴳⵉⵍ
families: ⵜⴰⵡⵊⵉⵡⵉⵏ
family: ⵜⴰⵡⵊⴰ
famine: ⴱⵓⵀⵢⵢⵓⴼ
famous: ⵉⵜⵜⵓⵙⵙⴰⵏⵏ
far: ⵢⴰⴳⴳⵓⴳ
farm: ⵜⴰⴱⵃⵉⵔⵜ
fat: ⵜⴰⴷⵓⵏⵜ
father: ⴰⴱⴰⴱⴰ
fatigue: ⴰⵕⵎⵎⵓⵢ
feature: ⵜⴰⵎⵙⵖⴰⵏⵜ
features: ⵜⵉⵎⵙⵖⴰⵏⵉⵏ
february: ⴱⵕⴰⵢⵕ
feedback: ⵜⴰⵔⴰⵔⴳⴰⵡⵜ
feedbacks: ⵜⵉⵔⴰⵔⴳⴰⵡⵉⵏ
feeling: ⴰⵙⵢⴰⴼⴰ
feelings: ⵉⵙⵢⴰⴼⴰⵜⵏ
feet: ⵉⴹⴰⵕⵏ
fence: ⵉⴼⵔⵉⴳ
fetus: ⴰⵔⵔⴰⵡ
few: ⵉⵎⵉⴽⴽ ⵏ
field: ⵉⴳⵔ
fields: ⵉⴳⵔⴰⵏ
fifty: ⵙⵎⵎⵓⵎⵔⴰⵡ
fig: ⵜⴰⵣⴰⵔⵜ
figure out: ⵙⵙⵏ
figure: ⵜⵓⵏⵓⵖⵜ
file: ⴰⴼⴰⵢⵍⵓ
files: ⵉⴼⴰⵢⵍⵓⵜⵏ
fin: ⵜⵉⵊⵉⴼⵔⵜ
finally: ⴳ ⵜⴳⵉⵔⴰ
finance: ⴰⵥⵕⴼ
financial: ⴰⵥⵕⴼⴰⵏ
finding: ⵜⵉⴼⵉⵜ
finger: ⴰⴹⴰⴹ
fingernail: ⵉⵙⴽⵔ
fingers: ⵉⴹⵓⴹⴰⵏ
finite: ⵉⵎⴷⵏ
fins: ⵜⵉⵊⵉⴼⴰⵔ
fire: ⴰⴼⴰ
first: ⴰⵎⵣⵡⴰⵔⵓ
firstly: ⴳ ⵜⵣⵡⵉⵔⵉ
fish: ⴰⵙⵍⵎ
fist: ⵜⵓⴽⴽⵉⵎⵜ
five: ⵙⵎⵎⵓⵙ
fixed: ⵉⵣⴳⴰⵏ
flatness: ⴰⵙⴼⵍⵡⴹ
flesh: ⴰⴽⵙⵓⵎ
flexibility: ⵜⴰⵍⵡⵉⵡⴹⵜ
flood: ⴰⵏⴳⴰⵢ
flower: ⵜⴰⵊⴷⴷⵉⴳⵜ
flowers: ⵉⵊⴷⴷⵉⴳⵏ
fog: ⵜⴰⴳⵓⵜ
folder: ⴰⵙⴷⴰⵡ
folders: ⵉⵙⴷⴰⵡⵏ
follow: ⴹⴼⴰⵔ
font: ⵜⴰⵙⵉⵙⴽⵍⵜ
fonts: ⵜⵉⵙⵉⵙⴽⵍⵉⵏ
food: ⴰⵎⵜⵛⵓ
foot: ⴰⴹⴰⵕ
football: ⵜⴰⵡⵊⵊⴰ ⵏ ⵓⴹⴰⵕ
force: ⴰⴷⵡⴰⵙ
forces: ⵉⴷⵡⴰⵙⵏ
forehead: ⴰⵏⵢⵉⵔ
forest: ⵜⴰⴳⴰⵏⵜ
forests: ⵜⴰⴳⴰⵏⵉⵏ
form: ⵜⴰⵍⵖⴰ
format: ⴰⵎⴰⵙⴰⵍ
formation: ⴰⵙⵉⵍⵖ
formats: ⵉⵎⵓⵙⴰⵍ
forms: ⵜⴰⵍⵖⵉⵡⵉⵏ
formula: ⵜⴰⵏⴼⴰⵍⵉⵜ
formulas: ⵜⵉⵏⴼⴰⵍⵉⵜⵉⵏ
fort: ⴰⴳⴰⴷⵉⵔ
fortnight: ⵙⵎⵎⵓⵙ ⴷ ⵎⵔⴰⵡ ⵏ ⵡⴰⵙⵙ
fortunately: ⵙ ⵜⵓⵎⵔⵜ
forty: ⴽⴽⵓⵎⵔⴰⵡ
forum: ⴰⵙⴳⵔⴰⵡ
forums: ⵉⵙⴳⵔⴰⵡⵏ
fossil: ⵜⴰⵏⴽⴼⵓⵍⵜ
fossils: ⵜⵉⵏⴽⴼⵓⵍⵉⵏ
foundation: ⵜⵉⵎⵔⵙⵍⵜ
founder: ⴰⵎⵙⵙⵔⵙⵍ
four-dimensional: ⴰⴽⵡⴰⵙⴽⵜⴰⵏ
four: ⴽⴽⵓⵥ
frame: ⴰⵙⴰⵜⵉ
free: ⵉⵍⴻⵍⵍⵉ
frequency: ⴰⵙⵏⴰⴳⴰⵔ
friction: ⴰⴽⵕⴰⴹ
frictions: ⵉⴽⵕⴰⴹⵏ
friday: ⴰⵙⵉⵎⵡⴰⵙ
friend: ⴰⵎⴷⴷⴰⴽⴽⵯⵍ
friends: ⵉⵎⴷⴷⵓⴽⴽⴰⵍ
friendship: ⵜⵉⴷⴷⵓⴽⴽⵍⴰ
friendships: ⵜⵉⴷⴷⵓⴽⴽⵍⵉⵡⵉⵏ
frog: ⴰⴳⵔⵓ
frogs: ⵉⴳⵯⵔⴰ
frost: ⵉⵡⵔⵉ
from: ⵙⴳ
front of: ⵎⵉⵏⴷ ⵏ
fruit: ⴰⴳⵓⵎⵎⵓ
fruits: ⵉⴳⵓⵎⵎⴰ
full: ⵉⵎⴷⵏ
function: ⵜⴰⵙⵖⵏⵜ
functionality: ⵜⴰⵎⵙⵖⵏⵜ
functions: ⵜⵉⵙⵖⵏⵉⵏ
fundamental: ⴰⵔⵙⵍⴰⵏ
fundamentals: ⵜⵉⵙⵉⵍⴰⵡⵉⵏ
future: ⵉⵎⴰⵍ
galaxies: ⵉⵎⴰⵣⵍⵍⴰⵡⵏ
galaxy: ⴰⵎⴰⵣⵍⵍⴰⵡ
game: ⵜⴰⵙⵓⵔⴰⵔⵜ
games: ⵜⵉⵙⵓⵔⴰⵔⵉⵏ
garden: ⵜⵓⵔⵜⵉⵜ
gardens: ⵜⵓⵔⵜⵉⵜⵉⵏ
garlic: ⵜⵉⵙⴽⵔⵜ
gas: ⵓⵔⵔⵉⴳ
gases: ⵓⵔⵔⵉⴳⵏ
gate: ⵜⴰⵡⵡⵓⵔⵜ
gender: ⵜⴰⵡⵙⵉⵜ
gene: ⴰⵊⵉⵏ
general: ⴰⵎⴰⵜⴰⵢ
generality: ⵜⴰⵎⴰⵜⴰⵢⵜ
generation: ⵜⴰⵙⵓⵜ
generations: ⵜⵉⵙⵓⵜⵉⵏ
generative: ⴰⵔⵡⴰⵏ
generator: ⴰⵎⵙⵙⴰⵔⵓ
genome: ⴰⵊⵉⵏⵓⵎ
geochemical: ⴰⴽⵔⵓⵔⴽⴰⵍ
geochemistry: ⵜⴰⴽⵔⵓⵔⴽⴰⵍⵜ
geodesy: ⵜⵉⴱⴹⵉⴽⴰⵍⵜ
geologist: ⴰⵎⵙⵏⴰⴽⴰⵍ
geologists: ⵉⵎⵙⵏⴰⴽⴰⵍⵏ
geology: ⵜⴰⵙⵏⴰⴽⴰⵍⵜ
geometric: ⴰⵏⵣⴳⴳⴰⵏ
geometrical: ⴰⵏⵣⴳⴳⴰⵏ
geometry: ⵜⴰⵏⵣⴳⴳⵉⵜ
geophysical: ⴰⵙⵏⴳⴰⵎⴰⴽⴰⵍ
geophysics: ⵜⴰⵙⵏⴳⴰⵎⴰⴽⴰⵍⵜ
get ready: ⵎⵓⵜⵜⴳ
gift: ⵜⴰⵡⴰⴼⴽⵉⵜ
gifts: ⵜⵉⵡⴰⴼⴽⵉⵡⵉⵏ
gills: ⵉⵖⵏⵡⴰⵣⵏⵏ
girl: ⵜⴰⵔⴱⴰⵜ
girls: ⵜⵉⵔⴱⴰⵜⵉⵏ
given: ⵜⵜⵓⴼⴽⴰⵏ
glissement: ⵓⵛⵓⴹ
globalization: ⵜⴰⵙⵎⴰⴹⴰⵍⵜ
goal: ⵉⵙⵡⵉ
goal: ⵜⵉⵎⵙⵙⵡⵉⵜ
goals: ⵜⵉⵎⵙⵙⵡⵉⵜⵉⵏ
goat: ⵜⴰⵖⴰⴹⵜ
goatskin: ⴰⴳⴷⴷⵉⴷ
gold: ⵓⵔⵖ
good: ⵉⴼⵓⵍⴽⵉⵏ
goodbye: ⴰⵔ ⵜⵉⵎⵏⵉⵍⵉⵜ
Google: ⴳⵓⴳⵍ
governance: ⵜⵉⵏⵏⵓⴱⴹⴰ
government: ⵜⴰⵏⴱⴰⴹⵜ
governor: ⴰⵏⴱⴱⴰⴹ
gracefully: ⵙ ⵓⵙⵓⵔⴼ
grain: ⴰⵇⵇⴰ
grain: ⴰⵇⵇⴰⵢⵏ
gram: ⴳⵕⴰⵎ
grammar: ⵜⴰⵊⵕⵕⵓⵎⵜ
grandeur: ⴰⵏⵛⵜ
grapes: ⴰⴹⵉⵍ
graphic: ⵜⴰⵡⵏⵖⴰ
graphics: ⵜⵉⵡⵏⵖⵉⵡⵉⵏ
grass: ⵜⵓⴳⴰ
grave: ⴰⵥⴽⴽⴰ
gravity: ⴰⵏⵣⵣⵓⵖ
great: ⴰⴽⵙⵡⴰⵜ
greek: ⴰⴳⵔⵉⴽⵉ
green: ⴰⵣⴳⵣⴰⵡ
greyhound: ⵓⵛⵛⴰⵢ
ground: ⴰⴽⴰⵍ
group: ⵜⴰⴳⵔⴰⵡⵜ
groups: ⵜⵉⴳⵔⴰⵡⵉⵏ
growing: ⵜⵉⴳⵎⵉ
growth: ⵜⵉⴳⵎⵉ
guarantee: ⴰⴹⴽⴰⵍ
habit: ⵜⴰⵎⵢⵓⵔⵜ
habits: ⵜⵉⵎⵢⵓⵔⵉⵏ
hail: ⵜⴰⴱⵔⵓⵔⵙⵜ
hair: ⴰⵣⵣⴰⵔ
half: ⴰⵣⴳⵏ
hammer: ⵜⴰⴼⴹⵉⵚⵜ
hand: ⴰⴼⵓⵙ
hands: ⵉⴼⴰⵙⵙⵏ
happily: ⵙ ⵜⵓⵎⵔⵜ
happiness: ⵜⵓⵎⵔⵜ
harbour: ⴰⴼⵜⴰⵙ
harvest: ⵜⴰⵎⴳⵔⴰ
hazard: ⴰⴳⴰⵛⵓⵔ
he: ⵏⵜⵜⴰ
head: ⵉⵖⴼ
healthy: ⵜⴰⴷⵓⵙⵉ
heart: ⵓⵍ
heat: ⵜⵉⵔⵖⵉ
hedgehog: ⵉⵏⵉⵙⵉ
heel: ⴰⵡⵔⵣ
heels: ⵉⵡⵔⵣⴰⵏ
height: ⵜⵉⵖⵣⵉ
hell: ⴰⵔⵡⴰⵙⵙ
hello: ⴰⵣⵓⵍ
help: ⵜⵉⵡⵉⵙⵉ
helping: ⵜⵉⵡⵉⵙⵉ
helpless: ⴰⵔⵡⵉⵙⵉ
her: ⵏⵏⵙ
herb: ⵜⵓⴳⴰ
herbs: ⵜⵓⴳⵡⵉⵏ
here: ⵖⵉⴷ
heritage: ⵜⴰⵢⵙⵉ
hero: ⴰⵏⴱⵔⴰⵣ
hers: ⵡⵉⵏⵏⵙ
hibro: ⴰⵣⵓⵍ ⵓⵎⴰ
high: ⵢⴰⵜⵜⵓⵢⵏ
high school: ⴰⵙⵉⵏⴰⵏ
highest: ⴰⵏⴰⴼⵍⵍⴰ
hill: ⵜⴰⵡⵔⵉⵔⵜ
his: ⵏⵏⵙ
history: ⴰⵎⵣⵔⵓⵢ
hobbie: ⵜⴰⵔⴰⵎⵙⵓⵜ
hobbies: ⵜⵉⵔⴰⵎⵙⵓⵜⵉⵏ
hoe: ⴰⴳⵍⵣⵉⵎ
hole: ⴰⴳⴱⴱⴰⵢ
holes: ⵉⴳⴱⴱⴰⵢⵏ
home: ⵜⵉⴳⵎⵎⵉ
homework: ⵜⴰⵡⵓⵔⵉ ⵏ ⵜⴳⵎⵎⵉ
honda: ⵀⵓⵏⴷⴰ
hope: ⴰⵏⴰⵔⵓⵣ
horizon: ⴰⵎⵏⵉⴷ
horn: ⵉⵛⵛⵡ
horse: ⴰⵢⵉⵙ
hospital: ⴰⵙⴳⵏⴰⴼ
hotel: ⴰⵙⵏⵙⵓ
hour: ⵜⴰⵙⵔⴰⴳⵜ
hours: ⵜⵉⵙⵔⴰⴳⵉⵏ
house: ⵜⵉⴳⵎⵎⵉ
houses: ⵜⵉⴳⵎⵎⴰ
housework: ⵜⴰⵡⵓⵔⵉ ⵏ ⵜⴳⵎⵎⵉ
however: ⵎⵇⵇⴰⵔ
huge: ⴰⴱⴰⵔⴰⵔ
human: ⴰⴼⴳⴰⵏ
humans: ⵎⴷⴷⵏ
humanity: ⵜⵉⴼⴼⵓⴳⵏⴰ
humidity: ⴰⴳⵓⵏⴷⵓ
humour: ⵜⴰⵇⴱⴱⴰⴹⵜ
hundred: ⵜⵉⵎⵉⴹⵉ
hundreds: ⵜⵉⵎⴰⴹ
hundredths: ⵉⴼⵎⵉⴹⵉⵜⵏ
hunger: ⵍⴰⵥ
hunter: ⴰⵏⴳⵎⴰⵔ
hunting: ⵜⴰⴳⵎⵔⵜ
husband: ⴰⵔⴳⴰⵣ
hyena: ⵉⴼⵉⵙ
hypotheses: ⵜⵓⵔⴷⵉⵡⵉⵏ
hypothesis: ⵜⵓⵔⴷⴰ
I: ⵏⴽⴽⵉ
ice: ⴰⴳⵔⵉⵙ
idea: ⵜⴰⵙⵡⵉⵏⴳⵎⵜ
ideas: ⵜⵉⵙⵡⵉⵏⴳⵉⵎⵉⵏ
identification: ⴰⵙⵎⴰⴳⵉ
identity: ⵜⴰⵎⴰⴳⵉⵜ
ideology: ⵜⴰⵙⵏⴰⴽⵜⴰ
if: ⵉⴳ
illumination: ⴰⵙⵉⴷⴷ
image: ⵜⵓⴳⵏⴰ
images: ⵜⵓⴳⵏⵉⵡⵉⵏ
imagination: ⵜⴰⵙⵓⴳⵉⵏⵜ
immediately: ⵏⵏⵉⵛⴰⵏ
immigrant: ⴰⵎⵣⵡⴰⴳ
immigration: ⴰⵣⵡⴰⴳ
impact: ⵜⴰⵣⵔⴰⵔⵜ
implementation: ⴰⵣⵣⴳⵉⵔ
implementing: ⴰⵣⵣⴳⵉⵔ
importance: ⵜⵉⵅⵅⵓⵜⵔⵜ
important: ⴰⵣⴰⵍⴰⵏ
impulse: ⵜⴰⵙⵏⴹⵡⵜ
in: ⵖ
income: ⴰⵎⴰⵖⵓⵍ
incorrect: ⵓⵔ ⵉⵖⵜⵉⵏ
increase: ⴰⵏⵏⵔⵏⵉ
indefinite: ⴰⵔⵓⵏⵎⵉⵍ
independence: ⴰⵣⴰⵔⵓⴳ
independent: ⴰⵎⵣⴰⵔⵓⴳ
index: ⴰⵎⴰⵜⴰⵔ
india: ⵍⵀⵏⴷ
indian: ⴰⵀⵉⵏⴷⵉ
indices: ⵉⵎⴰⵜⴰⵔⵏ
indirect: ⴰⵔⵓⵙⵔⵉⴷ
individual: ⵓⴼⵔⵉⴷ
individuals: ⵉⴼⵔⵉⴷⵏ
induction: ⵜⴰⵎⵙⴳⵍⵓⵜ
industry: ⵜⴰⵎⴳⵓⵔⵉ
inequality: ⵜⴰⵙⵎⵢⵉⴳⵉⵔⵜ
infinite: ⴰⵔⴳⵉⵔⴰⵏ
infinity: ⵜⴰⵔⴳⵉⵔⴰ
influence: ⵉⵣⵔⵉⵔⵉⵏ
information: ⵓⵎⵍⴰⵏ
infrastructure: ⵜⴰⴷⵓⵥⴽⵉⵡⵜ
inhabitance: ⵉⵎⵣⴷⴰⵖ
inheritance: ⵜⴰⵢⵙⵉ
initiation: ⴰⵙⵏⵜⵉ
inner: ⴰⴳⵏⵙⴰⵏ
innovation: ⵉⵙⵍⵍⵡⵉ
inorganic: ⴰⵔⴰⴳⵎⴰⵎⴰⵏ
input: ⵜⴰⵏⴽⵛⵓⵎⵜ
inputs: ⵜⵉⵏⴽⵛⵓⵎⵉⵏ
insect: ⴰⴱⵅⵅⵓⵢ
insecticide: ⴰⵏⵖⴰⴱⵅⵅⵓⵢ
insects: ⵉⴱⵅⵅⵓⵢⵏ
inside: ⴳ ⵓⴳⵏⵙⵓ
inspector: ⴰⵎⴳⴳⵉⵡⵙ
inspectors: ⵉⵎⴳⴳⵉⵡⴰⵙ
installation: ⴰⵣⵣⵓⴳⵣ
installed: ⵉⵜⵜⵓⵣⵓⴳⵣⵏ
installer: ⴰⵎⵣⵣⵓⴳⵣ
instance: ⵜⵓⵎⵎⴰⵏⵜ
instances: ⵜⵓⵎⵎⴰⵏⵉⵏ
institution: ⵜⵉⵎⵔⵙⵍⵜ
institutions: ⵜⵉⵎⵔⵙⴰⵍ
instruction: ⵜⴰⵏⴰⴹⵜ
instructions: ⵜⴰⵏⴰⴹⵉⵏ
instrument: ⴰⵍⵍⴰⵍ
insufficient: ⴰⵔⵎⵓⴷⵉ
insufficiently: ⵙ ⵓⵔⵎⵓⴷⵉ
integration: ⴰⵙⵉⴷⴼ
intellectual: ⴰⵎⴰⴳⴳⴰⴳ
intellectuals: ⵉⵎⴷⵍⴰⵙⵏ
intelligence: ⵜⵉⵖⵉⵙⵜ
intelligent: ⴰⵎⵉⵖⵉⵙ
intensity: ⵜⵉⴽⵔⵥⵉ
interaction: ⴰⵎⵢⴰⴳⴳⴰ
interactions: ⵉⵎⵢⴰⴳⴳⴰⵜⵏ
interactive: ⴰⵏⵎⵢⴰⴳⴳⴰ
interconnected: ⵉⵎⵢⴰⵇⵇⴰⵏⵏ
interdiction: ⵜⴰⴳⴷⵍⵜ
interest: ⴰⵏⵏⵣⴳⵎ
interests: ⵉⵏⵏⵣⴳⵓⵎⵏ
interface: ⴰⴳⵔⵓⴷⵎ
interference: ⴰⵎⵛⴽⵛⴰⵎ
intermediate: ⴰⵏⴰⵎⵎⴰⵙ
international: ⴰⴳⵔⴰⵖⵍⴰⵏ
interne: ⴰⴳⵏⵙⴰⵏ
internet: ⴰⵏⵜⵉⵔⵏⵉⵜ
interpretation: ⴰⵙⵏⵉⵎⴽ
interpreting: ⵓⵙⵏⵉⵎⴽ
intersection: ⴰⵎⵢⴰⴱⴰⵢ
interstellar: ⴰⴳⵔⵜⵔⵉ
interview: ⵜⴰⴷⵉⵡⵏⵏⵉⵜ
into: ⵖⵔ
introduces: ⴰⵔ ⵉⵙⵙⵏⴽⴰⴷ
introduction: ⵜⴰⵏⴽⴷⴰ
intuition: ⴰⴽⴰⵣ
invention: ⴰⵙⵏⵓⵍⴼⵓ
inventions: ⵉⵙⵏⵓⵍⴼⵓⵜⵏ
investing: ⴰⵙⵙⴰⵔⵡ
investment: ⴰⵙⵙⴰⵔⵡ
iron: ⵓⵣⵣⴰⵍ
irregular: ⴰⵔⵍⵓⴳⵏⴰⵏ
island: ⵜⴰⴳⵣⵉⵔⵜ
islands: ⵜⵉⴳⵣⵉⵔⵉⵏ
isometry: ⵜⴰⵣⵓⴽⵜⵉⵜ
isotope: ⴰⴽⵏⵉⴷⴳ
isotopes: ⵉⴽⵏⵉⴷⴳⵏ
it: ⵏⵜⵜⴰ
item: ⴰⴼⵔⴷⵉⵙ
items: ⵉⴼⵔⴷⵉⵙⵏ
iterating: ⴰⵍⵍⴰⵙ
iteration: ⴰⵍⵍⴰⵙ
iterations: ⴰⵍⵍⴰⵙⵏ
its: ⵏⵏⵙ
itself: ⵙ ⵢⵉⵖⴼ ⵏⵏⵙ
jackal: ⵓⵛⵛⵏ
january: ⵉⵏⵏⴰⵢⵔ
japan: ⴰⵢⴰⴱⴰⵏ
jaw: ⴰⴳⵊⴰ
job: ⵜⴰⵡⵓⵔⵉ
journal: ⴰⵖⵎⵉⵙ
journal: ⴰⵖⵎⵉⵙ
journey: ⵜⴰⵏⵢⵓⴷⴷⵓⵜ
joyful: ⵉⵎⵎⵔⵏ
jugement: ⴰⵣⴰⵔⴰⴼ
jugements: ⵉⵣⴰⵔⴰⴼⵏ
jupiter: ⴰⴷⴰⵏⴱⴰⵍⴰ
just: ⵀⵍⵍⵉ
key: ⵜⴰⵙⴰⵔⵓⵜ
kid: ⴰⵣⵣⴰⵏ
kids: ⴰⵣⵣⴰⵏⵏ
kilo: ⴽⵉⵍⵓ
kilometre: ⴽⵉⵍⵓⵎⵉⵜⵔ
kind: ⴰⵏⴰⵡ
kindergarten: ⵜⵓⵔⵜⵉⵜ ⵏ ⵉⵎⵥⵢⴰⵏⵏ
kinematics: ⵜⴰⵙⵏⵎⵓⵙⵙⵓⵜ
kinetic: ⴰⵏⵎⴰⵙⵙⵓ
kinetics: ⵜⴰⵎⵓⵙⵙⴰⵢⵜ
king: ⴰⴳⵍⵍⵉⴷ
kitchen: ⴰⵏⵡⴰⵍ
knee: ⴰⴼⵓⴷ
knowledge: ⵜⴰⵎⵙⵙⵏⴰ
known: ⵉⵜⵜⵓⵙⵙⴰⵏⵏ
laboratories: ⵉⵙⵓⵔⴰⵎ
laboratory: ⴰⵙⴰⵔⵎ
ladle: ⴰⵖⵏⵊⴰ
lake: ⴰⴳⵍⵎⵉⵎ
lamp: ⵜⴰⵙⴰⴼⵓⵜ
lamps: ⵜⵉⵙⴰⴼⵓⵜⵉⵏ
land: ⴰⴽⴰⵍ
language: ⵜⵓⵜⵍⴰⵢⵜ
languages: ⵜⵓⵜⵍⴰⵢⵉⵏ
large: ⴰⵅⴰⵜⴰⵔ
largest: ⴰⴽⴽⵯ ⵉⴳⴰⵏ ⴰⵎⵇⵔⴰⵏ
last: ⴰⵏⴳⴳⴰⵔⵓ
laughter: ⵜⴰⴹⵙⴰ
lava: ⴰⵍⴰⴼⴰ
law: ⴰⵙⵍⴳⵏ
laws: ⵉⵙⵍⴳⵏⵏ
layer: ⵜⴰⵔⴰⵢⵜ
layers: ⵜⴰⵔⴰⵢⵉⵏ
lead: ⴰⵍⴷⵓⵏ
leader: ⴰⵎⵖⴰⵔ
leaf: ⵉⴼⵔ
learn: ⵍⵎⴷ
learning: ⴰⵍⵎⵎⵓⴷ
least: ⵉⴷⵔⵓⵙ
left: ⴰⵣⵍⵎⴰⴹ
leg: ⴰⴹⴰⵕ
legal: ⵓⵍⴳⵉⵏ
legality: ⵜⵉⵍⵍⵓⴳⵏⴰ
legend: ⵓⵎⵉⵢ
legends: ⵓⵎⵉⵢⵏ
legitimacy: ⵜⴰⵣⵔⴼⴰ
legs: ⵉⴹⴰⵕⵏ
length: ⵜⴰⵖⵣⵉ
leopard: ⴰⵖⵉⵍⴰⵙ
lesson: ⵜⴰⵎⵙⵉⵔⵜ
lessons: ⵜⵉⵎⵙⵉⵔⵉⵏ
level: ⴰⵙⵡⵉⵔ
levels: ⵉⵙⵡⵉⵔⵏ
lexical: ⴰⵎⴰⵡⴰⵍⴰⵏ
lexicon: ⴰⵎⴰⵡⴰⵍ
libraries: ⵜⵉⵙⴷⵍⵉⵙⵉⵏ
library: ⵜⴰⵙⴷⵍⵉⵙⵜ
licence: ⵜⵓⵔⴰⴳⵜ
life: ⵜⵓⴷⵔⵜ
light: ⵜⵉⴼⴰⵡⵜ
lightning: ⵓⵙⵎ
like: ⵣⵓⵏ ⴷ
limit: ⴰⵡⵜⵜⵓ
limits: ⵉⵡⵜⵜⴰ
line: ⴰⵣⵔⵉⴳ
linear: ⴰⵎⵣⵉⵔⴳ
lines: ⵉⵣⵔⵉⴳⵏ
link: ⴰⵙⵖⵓⵏ
links: ⵉⵙⵖⵓⵏⵏ
lion: ⵉⵣⵎ
liquid: ⴰⴱⵍⵓⵍⵓ
list: ⵜⴰⵍⴳⴰⵎⵜ
lists: ⵜⵉⵍⴳⴰⵎⵉⵏ
literature: ⵜⴰⵙⴽⵍⴰ
litre: ⵍⵉⵜⵔⵓ
liver: ⵜⴰⵙⴰ
livestock: ⴰⵛⵜⴰⵍ
living: ⵉⴷⴷⵔⵏ
lizard: ⵜⴰⵣⵔⵎⴻⵎⵎⵓⵢⵜ
loading: ⴰⴳⴳⴰⵎ
loan: ⴰⵔⵟⵟⴰⵍ
loans: ⵉⵔⵟⵟⴰⵍⵏ
local: ⴰⴷⵉⴳⴰⵏ
location: ⴰⴷⵖⴰⵔ
logic: ⵜⴰⵎⵥⵍⴰ
logical: ⴰⵎⵥⵍⴰⵏ
logically: ⵙ ⵜⵎⵥⵍⴰ
london: ⵍⵓⵏⴷⵓⵏ
long: ⵓⵖⵣⵉⴼ
loom: ⴰⵥⵟⵟⴰ
loop: ⵜⵓⵍⵍⵓⵙⵜ
loops: ⵜⵓⵍⵍⵓⵙⵉⵏ
loser: ⴰⵎⴳⵓⴼ
losers: ⴰⵎⴳⵓⴼⵏ
lot: ⵜⵓⴳⵜⵜ
love: ⵜⴰⵢⵔⵉ
lunar: ⴰⵢⵢⵓⵔⴰⵏ
lunch: ⵉⵎⴽⵍⵉ
machine: ⵜⴰⵎⴰⵛⵉⵏⵜ
machines: ⵜⵉⵎⴰⵛⵉⵏⵉⵏ
macos: ⵎⴰⴽⵓⵙ
macroscopic: ⴰⵎⵖⵔⵥⵕⴰⵢ
magma: ⴰⵎⴰⴳⵎⴰ
magnetic: ⴰⴷⴽⵔⴰⵏ
magnetism: ⵜⴰⴷⴽⵔⵉⵜ
main: ⴰⵙⵉⵍⴰⵏ
majority: ⵜⵓⴳⵜⵜ
making: ⴰⵙⴽⴽⵉⵔ
mammal: ⴰⵙⵓⵟⵟⴰⴹ
mammals: ⵉⵙⵓⵟⵟⴰⴹⵏ
man: ⴰⵔⴳⴰⵣ
management: ⴰⵙⵡⵓⴷⴷⵓ
manifestation: ⵜⴰⵎⵙⴽⴰⵏⵜ
manifold: ⴰⵎⵙⴳⵔⵓ
manipulation: ⴰⵙⵎⵙⵓⵔⴰⵔ
many: ⵎⵏⵏⴰⵡ
march: ⵎⴰⵕⵚ
marginalization: ⴰⵙⵙⵉⵏⴼ
market: ⴰⴳⴰⴷⴰⵣ
markets: ⵉⴳⴰⴷⴰⵣⵏ
marriage: ⵉⵡⵍ
mars: ⵉⵎⵣⵉⵡⵖ
mass: ⵜⴰⵙⴰⴽⴰⵢⵜ
math: ⵜⵓⵙⵏⴰⴽⵜ
mathematical: ⴰⵙⵏⴰⴽⵜⴰⵏ
mathematics: ⵜⵓⵙⵏⴰⴽⵜ
matrix: ⵉⵙⵉⵔⵡ
matter: ⵜⴰⵏⴳⴰ
maybe: ⵢⴰⵍⵍⴼⵓⵙ
meaning: ⴰⵏⴰⵎⴽ
meaningful: ⴰⵎⵙⵏⵓⵎⴽ
measurement: ⴰⵙⵖⴰⵍ
measurements: ⵉⵙⵖⴰⵍⵏ
meat: ⴰⴽⵙⵓⵎ
mechanics: ⵜⴰⵙⵏⴷⴷⵓⵜ
mechanism: ⵜⴰⵙⵎⵙⴷⴷⵓⵜ
mechanisms: ⵜⵉⵙⵎⵙⴷⴷⵓⵜⵉⵏ
median: ⴰⵏⴰⵎⵎⴰⵙ
medical: ⴰⵎⵙⵏⵉⵊⵊⵉ
medicine: ⵜⴰⵙⵏⵉⵊⵊⵉⵜ
medium: ⴰⵏⴰⵎⵎⴰⵙ
member: ⴰⴳⵎⴰⵎ
members: ⵉⴳⵎⴰⵎⵏ
membrane: ⴰⵍⵎⴳⵎⴰⵎ
memory: ⵜⵉⵎⴽⵜⵉⵜ
memories: ⵜⵉⵎⴽⵜⵉⵜⵉⵏ
men: ⵉⵔⴳⴰⵣⵏ
mentality: ⵜⵉⴳⵓⵔⵔⵡⴰ
menu: ⵜⴰⵍⴳⴰⵎⵜ
mercury: ⴰⵣⵡⴰⵇ
message: ⵜⴰⴱⵔⴰⵜ
messages: ⵜⵉⴱⵔⴰⵜⵉⵏ
metabolic: ⴰⵎⵉⵜⴰⴱⵓⵍⵉ
metabolism: ⴰⵎⵉⵜⴰⴱⵓⵍⵉⵣⵎ
metaphysical: ⴰⴼⵔⴳⴰⵎⴰⵏ
metaphysics: ⵜⴰⴼⵔⴳⴰⵎⴰ
metathesis: ⵜⵉⵎⵍⴻⵍⵍⵉⵜ
meteor: ⴰⵣⵔⵉⵜ
meteors: ⵉⵣⵔⵉⵜⵏ
method: ⵜⴰⴱⵔⵉⴷⵜ
methodology: ⵜⴰⵙⵏⴱⵔⵉⴷⵜ
methods: ⵜⵉⴱⵔⵉⴷⵉⵏ
metonymy: ⵜⴰⵢⴹⵉⵙⵎ
metrology: ⵜⴰⵙⵏⵙⵖⵉⵍⵜ
mice: ⵉⵖⵔⴷⴰⵢⵏ
microbe: ⴰⵎⵥⵉⴷⵔ
microorganism: ⴰⵎⵥⵉⴷⵓⵙ
microorganisms: ⵉⵎⵥⵉⴷⵓⵙⵏ
microprocessor: ⴰⵎⵥⵉⵙⵎⴽⴰⵍ
microscope: ⴰⵎⵥⵉⵥⵕⵉ
microscopic: ⴰⵎⵥⵉⵥⵕⴰⵢ
microsystem: ⴰⵎⵥⵉⵏⴳⵔⴰⵡ
microsystems: ⵉⵎⵥⵉⵏⴳⵔⴰⵡⵏ
microwave: ⵜⴰⵎⵥⵉⵢⵢⵓⵖⵜ
middle: ⵜⵓⵥⵥⵓⵎⵜ
midnight: ⵜⵓⵥⵥⵓⵎⵜ ⵏ ⵢⵉⴹ
migration: ⴰⵣⵡⴰⴳ
milk: ⴰⴽⴼⴼⴰⵢ
mill: ⵜⵉⵙⵉⵔⵜ
million: ⴰⴳⵏⴷⵉⴷ
millions: ⵉⴳⵏⴷⵉⴷⵏ
mind: ⵜⴰⴳⵔⵔⴰⵡⵜ
mindset: ⵜⵉⴳⵓⵔⵔⵡⴰ
mine: ⵡⵉⵏⵓ
mine(ore): ⴰⵣⴰⵖⵓⵣ
mineral: ⴰⵎⵖⵓⵣ
mineralogy: ⵜⴰⵙⵏⵎⵖⵓⵣⵜ
minerals: ⵉⵎⵖⵓⵣⵏ
minorities: ⵜⵉⴷⵔⵓⵙⵉⵏ
minority: ⵜⴰⴷⵔⵓⵙⵜ
minute: ⵜⵓⵙⴷⵉⴷⵜ
minutes: ⵜⵓⵙⴷⵉⴷⵉⵏ
miracle: ⵜⴰⵎⴽⵔⵔⴰ
miracles: ⵜⵉⵎⴽⵔⵔⵉⵡⵉⵏ
mirror: ⵜⵉⵙⵉⵜ
mirrors: ⵜⵉⵙⵉⵜⵉⵏ
mission: ⵜⴰⵖⵍⵉⴼⵜ
missions: ⵜⵉⵖⵍⵉⴼⵉⵏ
mistake: ⴰⵣⴳⴰⵍ
mistakes: ⵉⵣⴳⴰⵍⵏ
mitochondria: ⴰⵎⵉⵜⵓⴽⵓⵏⴷⵔⵉ
mitochondrial: ⴰⵎⵉⵜⵓⴽⵓⵏⴷⵔⵉ
mixing: ⴰⵙⵎⵙⵢ
mobile: ⴰⵣⵉⵔⴰⵣ
modalities: ⵜⵉⵙⴽⴰⵔⵉⵏ
modality: ⵜⴰⵙⴽⴰⵔⵜ
mode: ⴰⵎⵓⴽⵏ
model: ⴰⵣⵓⵔⵜ
models: ⵉⵣⵓⵔⵜⴰ
modern: ⴰⵜⵔⴰⵔ
modernity: ⵜⴰⵜⵔⴰⵔⵉⵜ
modes: ⵉⵎⵓⴽⵏⵏ
modular: ⴰⵣⴳⵔⴰⵔ
module: ⴰⵣⴳⵔⵉⵔ
modules: ⵉⵣⴳⵔⵉⵔⵏ
molecular: ⴰⵏⵛⵜⵉⵡⴰⵏ
molecule: ⵜⴰⵏⵛⵜⵉⵡⵜ
molecules: ⵜⵉⵏⵛⵜⵉⵡⵉⵏ
momentum: ⵜⵉⵔⵎⵍⵜ ⵜⵉⵎⵙⴷⴷⵓⵜ
money: ⵉⴷⵔⵉⵎⵏ
month: ⴰⵢⵢⵓⵔ
months: ⵉⵔⵏ
monday: ⴰⵢⵏⴰⵙ
moon: ⴰⵢⵢⵓⵔ
moons: ⴰⵢⵢⵓⵔⵏ
more: ⵓⴳⴳⴰⵔ
moreover: ⵙ ⵜⵎⵔⵏⵉⵡⵜ
morning: ⵜⵉⴼⴰⵡⵜ
morphology: ⵜⴰⵙⵏⴰⵍⵖⴰ
morphometric: ⴰⴽⵜⴰⵍⵖⴰⵏ
morocco: ⵎⵓⵔⴰⴽⵓⵛ
moset: ⵜⵓⴳⵜⵜ
mosque: ⵜⴰⵎⵉⵣⴳⵉⴷⴰ
most: ⵓⴳⴳⴰⵔ
mother: ⵜⴰⵢⵎⵎⴰⵜ
motion: ⴰⵎⵓⵙⵙⵓ
motocycle: ⵜⴰⵙⵏⵙⵖⴰⵍⵜ
mountain: ⴰⴷⵔⴰⵔ
mountains: ⵉⴷⵔⴰⵔⵏ
mouth: ⵉⵎⵉ
mouths: ⵉⵎⴰⵡⵏ
mounting: ⴰⵙⵎⴷⵢ
mouse: ⴰⵖⵔⴷⴰ
movement: ⴰⵎⵓⵙⵙⵓ
movements: ⵉⵎⵓⵙⵙⵓⵜⵏ
multi-modal: ⴰⴳⵜⴰⵣⵓⵔⵜ
multiple: ⵎⵏⵏⴰⵡ
multiplication: ⴰⵙⴳⴰⵜ
multiplicity: ⵜⴰⵎⴰⴳⵓⵜⵜ
murder: ⵜⵉⵎⵏⵖⵉⵡⵜ
muscle: ⵜⴰⴽⵙⵓⵎⵜ
muscles: ⵜⵉⴽⵙⵓⵎⵉⵏ
muscular: ⴰⵏⴽⵙⵓⵎ
music: ⴰⵥⴰⵡⴰⵏ
must: ⵉⴼⵓⴽⴽ
mutable: ⴰⵎⵎⵏⴼⴰⵍ
mutation: ⵜⴰⴹⵕⵎⵉⵙⵜ
mutations: ⵜⵉⴹⵕⵎⵉⵙⵉⵏ
my: ⵉⵏⵓ
mysterious: ⵉⵎⴷⵔⴳ
myth: ⵓⵎⵉⵢ
name: ⵉⵙⵎ
nanotechnologies: ⵜⴰⵏⴰⵏⵓⵙⵏⵜⵡⵉⵍⵉⵏ
nanotechnology: ⵜⴰⵏⴰⵏⵓⵙⵏⵜⵡⵉⵍⵜ
nation: ⴰⵖⵍⴰⵏ
national: ⴰⵎⵓⵔⴰⵏ
natural: ⴰⴳⴰⵎⴰⵏ
nature: ⴰⴳⴰⵎⴰ
natures: ⵉⴳⴰⵎⴰⵜⵏ
navigation: ⵜⵓⵏⵉⴳⵉⵏ
nebula: ⵉⵡⵉⵥ
nebulae: ⵉⵡⵉⵥⵏ
necessary: ⵉⵛⵛⵍⵏ
neck: ⴰⵎⴳⴳⵕⴹ
needle: ⵜⵉⵙⵙⴳⵏⵉⵜ
negative: ⵓⵣⴷⵉⵔ
negotiation: ⴰⵎⵙⴰⵛⴽⴰ
neighbor: ⴰⵏⴰⵔⴰⴳ
neighbors: ⵉⵏⴰⵔⴰⴳⵏ
neptune: ⵏⵉⴱⵜⵓⵏ
nerve: ⴰⵣⵍⵍⵓⵎ
nervous: ⴰⵏⵣⵍⵓⵎ
nest: ⴰⴳⴷⴼ
network: ⵜⴰⵔⴰⵜⵙⴰ
networks: ⵜⵉⵔⴰⵜⵙⵉⵡⵉⵏ
neural: ⴰⵏⵣⵍⵓⵎ
neurological: ⴰⵙⵏⵣⵍⵎⴰⵏ
neurology: ⵜⴰⵙⵏⵣⵍⵍⵓⵎⵜ
neuron: ⵜⴰⵖⵔⴰⵙⵜ ⵜⴰⵏⵣⵍⵓⵎⵜ
neurons: ⵜⵉⵖⵔⴰⵙⵉⵏ ⵜⵉⵏⵣⵍⵓⵎⵉⵏ
neutral: ⴰⵔⴰⵡⵙⴰⵏ
neutrality: ⵜⴰⵔⴰⵡⵙⵉⵜ
neutron: ⴰⵏⵢⵓⵜⵕⵓⵏ
neutrons: ⵉⵏⵢⵓⵜⵕⵓⵏⵏ
new: ⴰⵎⴰⵢⵏⵓ
news: ⵉⵏⵖⵎⵉⵙⵏ
newspaper: ⴰⵖⵎⵉⵙ
never: ⵊⵊⵓ
next: ⴰⵏⴹⴼⴰⵕ
night: ⵉⴹ
nightmare: ⴱⴰⵖⵔⴰⵔ
nine: ⵜⵥⴰ
ninety: ⵜⵥⴰⵎⵔⴰⵡ
nipple: ⵜⵉⴷⵔⵖⵜ
no: ⵓⵀⵓ
noon: ⴰⵣⴰⵍ
node: ⵜⵓⴽⵔⵉⵙⵜ
nodes: ⵜⵓⴽⵔⵉⵙⵉⵏ
non-physical: ⴰⵔⴰⵏⴳⴰⵏ
none: ⴰⵎⵢⴰ
norm: ⵜⴰⵍⵓⴳⵏⵜ
north: ⴰⴳⴰⴼⴰ
nose: ⴰⵏⵣⴰⵔ
noses: ⴰⵏⵣⴰⵔⵏ
nostril: ⵜⵉⵏⵣⵔⵜ
notary: ⴰⵙⵏⵜⴰⵎ
notebook: ⴰⵍⵓⴳ
notebooks: ⵉⵍⵓⴳⵏ
nothing: ⴰⵎⵢⴰ
notice: ⵜⵓⵙⵎⵉⵔⵜ
noun: ⵉⵙⵎ
novel: ⵓⵏⴳⴰⵍ
novels: ⵓⵏⴳⴰⵍⵏ
now: ⵖⵉⵍⴰ
nuclear: ⴰⵖⵢⴰⵢⴰⵏ
nucleus: ⴰⵖⵢⴰⵢ
number: ⴰⵎⴹⴰⵏ
numbers: ⵉⵎⴹⴰⵏⵏ
nutrients: ⵉⴼⵔⴷⵉⵙⵏ ⵉⵎⵙⴰⴷⵓⵔⵏ
object: ⴰⵙⴽⴽⵉⵏ
objective: ⴰⵙⴰⵖⴷ
objectives: ⵉⵙⴰⵖⴷⵏ
objectivity: ⵜⴰⵎⵙⵖⴰⵔⴰ
objects: ⵉⵙⴽⴽⵉⵏⵏ
observable: ⴰⵣⵎⵔⵙⵏⴰⵖⵙ
observation: ⴰⵙⵏⴰⵖⵙ
observations: ⵉⵙⵏⴰⵖⵙⵏ
observer: ⴰⵎⵙⵏⴰⵖⵙ
observers: ⵉⵎⵙⵏⴰⵖⵙⵏ
obstacle: ⴰⵙⴷⵔⵎ
obstacles: ⵉⵙⴷⵔⴰⵎ
obtain: ⴰⵎⵥ
obtaining: ⴰⵎⵎⴰⵥ
occasion: ⵜⴰⵎⵍⴷⴰ
occasions: ⵜⵉⵎⵍⴷⵉⵡⵉⵏ
occur: ⵎⵙⴰⵔ
ocean: ⴰⴳⴰⵔⴰⵡ
oceans: ⵉⴳⴰⵔⴰⵡⵏ
of: ⵏ
official: ⴰⵎⴰⴷⴷⴰⴷ
ok: ⵎⵢⵢⴰ ⵏ ⵄⵍⴰ ⵅⵉⵔ
old: ⴰⵡⵙⵙⴰⵔ
olives: ⴰⵣⵎⵎⵓⵔ
on: ⵖⴼ
once: ⴰⴷ ⵓⴽⴰⵏ
oncology: ⵜⴰⵙⵏⴼⴰⴼⵜ
one: ⵢⴰⵏ
onions: ⴰⵥⴰⵍⵉⵎ
online: ⴳ ⵓⵣⵔⵉⴳ
only: ⵖⵙ
open-source: ⵜⴰⵔⵥⵎⵙⴰⴳⵎⵜ
open: ⵔⵥⵎ
operating: ⴰⵙⵎⴰⵀⵍ
operation: ⵜⴰⵎⵀⵍⵜ
operations: ⵜⵉⵎⵀⵍⵉⵏ
operator: ⴰⵎⴰⵀⴰⵍ
opinion: ⵜⴰⵏⵏⴰⵢⵜ
opportunity: ⴰⵙⵓⵍⴼ
opposite: ⴰⵏⵎⴳⴰⵍ
opposition: ⵜⴰⵏⵎⴳⵍⴰ
optic: ⵉⵎⵙⵏⴰⴼⴰ
optics: ⵜⴰⵙⵏⴰⴼⴰⵜ
optimal: ⵉⵎⵉⴼⵉⵡ
optimalisation: ⴰⵙⵖⵓⴷⵓ
option: ⵜⴰⴷⵖⵔⵜ
optional: ⴰⴷⵖⵔⴰⵏ
options: ⵜⵉⴷⵖⵔⵉⵏ
or: ⵏⵖ
oral: ⴰⵎⵉⵡⴰⵏ
orality: ⵜⵉⵎⴰⵡⵉⵜ
orbit: ⴰⵥⵢⴰⵕ
orbits: ⵉⵥⵢⴰⵕⵏ
orchard: ⵓⵔⵜⵉ
orchards: ⵓⵔⵜⴰⵏ
order: ⴰⵏⵎⴰⵍⴰ
ordinary: ⴰⵎⴰⴳⵏⵓ
organ: ⴰⴳⵎⴰⵏ
organic: ⴰⴳⵎⴰⵎⴰⵏ
organised: ⵉⵏⵎⴰⵍⴰⵏ
organism: ⵓⴷⵓⵙ
organisms: ⵓⴷⵓⵙⵏ
organization: ⵜⴰⵎⴰⴷⴷⴰⵙⵜ
organized: ⵉⵜⵜⵓⵙⵓⴷⵙⵏ
organs: ⵉⴳⵎⴰⵎⵏ
orientation: ⴰⵙⵡⴰⵍⴰ
orientations: ⵉⵙⵡⴰⵍⴰⵜⵏ
orifice: ⵜⵉⴼⵍⵉⵜ
origin: ⴰⵙⴰⵍⴰ
original: ⴰⵙⴰⵍⴰⵏ
origins: ⵉⵙⴰⵍⴰⵜⵏ
orthogonal: ⴰⴱⴷⴷⴰⵢ
other: ⵢⴰⴹⵏ
others: ⵡⵉⵢⵢⴰⴹ
otherwise: ⵎⴽ ⵓⵀⵓ
our: ⵏⵏⵖ
ours: ⵡⵉⵏⵏⵖ
ourselves: ⵉⵖⴼⴰⵡⵏ ⵏⵏⵖ
output: ⵜⵓⴼⴼⵖⴰ
outside: ⴱⵕⵕⴰ
overload: ⵜⴰⵏⴳⴽⵜⵔⵜ
ox: ⴰⴼⵓⵏⴰⵙ
page: ⵜⴰⵙⵏⴰ
pages: ⵜⴰⵙⵏⵉⵡⵉⵏ
pair: ⴰⵢⵓⴳⴰⵏ
pairs: ⴰⵢⵓⴳⴰⵏⵏ
pants: ⴰⴽⵔⴱⴰⵢ
paper: ⴰⴼⵔⴽⵓⴽ
paradigm: ⴰⵎⵖⴰⵡⴰⵍ
paradigms: ⵉⵎⵖⴰⵡⴰⵍⵏ
parallel: ⴰⵏⵎⵙⴰⴷⴰⵖ
parent: ⴰⵎⴰⵔⴰⵡ
parents: ⵉⵎⴰⵔⴰⵡⵏ
parser: ⴰⵎⵙⵍⴰⴹ
parsing: ⴰⵙⵍⴰⴹ
part: ⴰⴳⵣⵣⵓⵎ
particle: ⴰⴼⴽⴽⵉⵡ
particles: ⵉⴼⴽⴽⵉⵡⵏ
particularly: ⵙⵍⴰⵡⴰⵏ
partridge: ⵜⴰⵙⴽⴽⵓⵔⵜ
parts: ⵉⴳⵣⵣⵓⵎⵏ
party: ⵜⴰⵎⵖⵔⴰ
passcode: ⵜⴰⵏⴳⴰⵍⵜ ⵏ ⵓⵣⵔⴰⵢ
passcodes: ⵜⴰⵏⴳⴰⵍⵉⵏ ⵏ ⵓⵣⵔⴰⵢ
passion: ⴰⵏⵏⵖⵣⵍ
passions: ⵉⵏⵏⵖⵣⴰⵍ
password: ⵜⴰⴳⵓⵔⵉ ⵏ ⵓⵣⵔⴰⵢ
passwords: ⵜⴰⴳⵓⵔⵉⵡⵉⵏ ⵏ ⵓⵣⵔⴰⵢ
past: ⵉⵣⵔⵉ
paste: ⵙⵍⵖ
path: ⴰⴱⵔⵉⴷ
pathogen: ⴰⵎⵙⴽⵔⴰⵟⵟⴰⵏ
paths: ⵉⴱⵔⵉⴷⵏ
patience: ⴰⵥⵉⴹⵕ
patient: ⴰⵎⴰⴹⵓⵏ
patients: ⵉⵎⴰⴹⵓⵏⵏ
patrimony: ⴰⵢⴷⴰ
pattern: ⴰⵣⵓⵔⵜ
patterns: ⵉⵣⵓⵔⵜⴰ
peace: ⴰⴼⵔⴰ
pear: ⵜⴰⴼⵉⵔⴰⵙⵜ
pears: ⵜⵉⴼⵉⵔⴰⵙ
people: ⵎⴷⴷⵏ
percent: ⴳ ⵜⵎⵉⴹⵉ
percentage: ⵜⵉⴳⵎⵉⴹⵉ
perception: ⵜⴰⵡⴰⵍⵉⵜ
perfect: ⵓⵎⵎⵉⴷ
performance: ⴰⵎⵍⴰⵣⵎⴰⵔ
perhaps: ⴰⵀⴰⵜ
period: ⵜⴰⵡⴰⵍⴰ
periodic: ⴰⵡⴰⵍⴰⵏ
permission: ⴰⵜⵔⵓⴳ
permissions: ⵉⵜⵔⵓⴳⵏ
person: ⵓⴳⴳⵉⴷ
personal: ⴰⵏⵉⵎⴰⵏ
personality: ⵜⵉⵡⵡⵓⵔⴽⴰ
perception: ⴰⵎⵏⵉⴷ
pharmacy: ⵜⴰⵙⴰⵙⴼⵔⵜ
phase: ⵜⴰⴼⵔⴽⵜ
phases: ⵜⵉⴼⵔⴽⵉⵡⵉⵏ
phenomena: ⵜⵓⵎⴰⵏⵉⵏ
phenomenon: ⵜⵓⵎⴰⵏⵜ
philosophy: ⵜⴰⴼⵍⵙⴰⴼⵜ
phone: ⵜⵉⵍⵉⴼⵓⵏ
phonetics: ⵜⵉⵎⵙⵉⵙⵍⵉⵜ
phonic: ⴰⵎⵙⵉⵙⵍⴰⵏ
phonology: ⵜⴰⵙⵏⵎⵙⵍⵉⵜ
photo: ⵜⴰⵡⵍⴰⴼⵜ
photography: ⵜⴰⵙⴽⵏⴼⴰⵡⵜ
photosynthesis: ⵜⴰⵙⵓⴷⴼⴰⵡⵜ
phrase: ⵜⴰⵏⴼⴰⵍⵉⵜ
phrases: ⵜⵉⵏⴼⴰⵍⵉⵢⵉⵏ
physical: ⴰⵎⵜⵜⴰⵡ
physicochemical: ⴰⴳⴰⵎⴰⴽⵔⵓⵔⴰⵏ
physics: ⵜⴰⵙⵏⴳⴰⵎⴰ
piano: ⴰⴱⵢⴰⵏⵓ
picture: ⵜⴰⵡⵍⴰⴼⵜ
pictures: ⵜⵉⵡⵍⴰⴼⵉⵏ
piece: ⵜⴰⴳⵣⵣⵓⵎⵜ
pier: ⴰⵙⴰⵍⵉ
pigeon: ⴰⵜⴱⵉⵔ
pillow: ⵜⴰⵙⵓⵎⵜⴰ
pitchfork: ⵜⴰⵣⵣⴰⵔⵜ
place: ⴰⴷⵖⴰⵔ
plain: ⴰⵣⴰⵖⴰⵔ
plan: ⴰⵖⴰⵡⴰⵙ
planaire: ⵓⴳⵏⵉⵡ
planet: ⴰⵎⵜⵉⵡⴳ
planets: ⵉⵎⵜⵉⵡⴳⵏ
planning: ⴰⵙⵖⵉⵡⵙ
plans: ⵉⵖⴰⵡⴰⵙⵏ
plant: ⵉⵎⵖⵉ
plants: ⵉⵎⵖⵉⵢⵏ
plasma: ⵜⴰⴼⵍⴰⵥⵎⴰ
platform: ⵜⵉⵔⵉⵔⴹⵜ
platforms: ⵜⵉⵔⵉⵔⴰⴹ
play: ⵓⵔⴰⵔ
player: ⴰⵎⵓⵔⴰⵔ
players: ⵉⵎⵓⵔⴰⵔⵏ
playing: ⵓⵔⴰⵔ
plays: ⵜⵜⵓⵔⴰⵔ
please: ⴰⵎⵓⵔ ⵏⵏⴽ
plural: ⴰⵎⴰⴳⵓⵜ
pluto: ⴱⵍⵓⵜⵓ
poem: ⵜⵉⵣⵍⵉⵜ
poems: ⵜⵉⵣⵍⴰⵜⵉⵏ
poet: ⴰⵎⴷⵢⴰⵣ
poetry: ⵜⴰⵎⴷⵢⴰⵣⵜ
point: ⵜⴰⵇⵉⴼⵉⵜ
points: ⵜⵉⵇⵉⴼⴰ
polarization: ⴰⵙⵉⵅⴼ
pole: ⴰⵙⴼⴰⵢⵍⵓ
police: ⵍⴱⵓⵍⵉⵙ
politics: ⵜⴰⵙⵔⵜⵉⵜ
pollution: ⵜⵉⵎⵔⴽⵉⵜ
polymorphism: ⵜⴰⴳⵜⴰⵍⵖⴰ
pond: ⴰⵎⴷⴰ
popular: ⴰⵖⵔⴼⴰⵏ
porcupine: ⴰⵔⵓⵢ
portfolio: ⴰⵙⴷⴰⵡ ⵏ ⵜⵙⵓⴳⴰⵔ
portfolios: ⵉⵙⴷⴰⵡⵏ ⵏ ⵜⵙⵓⴳⴰⵔ
positive: ⵓⵎⵏⵉⴳ
possess: ⵟⵟⴼ
possibilities: ⵜⴰⵍⵍⴼⵓⵙⵉⵏ
possibility: ⵜⴰⵍⵍⴼⵓⵙⵜ
possible: ⴰⵎⴰⵍⵍⴼⵓⵙ
post: ⵜⵓⴼⵙⵉⵔⵜ
posts: ⵜⵓⴼⵙⵉⵔⵉⵏ
potilics: ⵜⴰⵙⵔⵜⵉⵜ
potilical: ⴰⵙⵔⵜⴰⵏ
poverty: ⴰⵥⵍⴰⴹ
power: ⵜⴰⵥⴹⴰⵕⵜ
powers: ⵜⵉⵥⴹⴰⵕⵉⵏ
powerful: ⵉⴷⵓⵙⵏ
practical: ⴰⵍⵉⵍⴰⵏ
precious: ⴰⵣⴰⵍⴰⵏ
precision: ⵜⵉⵙⴷⴷⵉ
preference: ⴰⵙⵎⵢⵉⴼⵉ
preferences: ⵉⵙⵎⵢⵉⴼⵉⵜⵏ
prehistory: ⴰⵣⵔⵎⵣⵔⵓⵢ
preoccupation: ⴰⵏⵣⴳⵓⵎ
preparation: ⴰⵙⵎⵓⵜⵜⴳ
presence: ⴰⵎⵎⴳⵏⵜ
present: ⴰⵎⵉⵍⴰⵏ
presentation: ⴰⵙⵏⴽⴷ
pressure: ⴰⴷⴷⴰⵔ
preview: ⵜⴰⵙⴽⴰⵏⵜ
prevision: ⴰⴹⴽⴰⴹ
price(s): ⴰⵜⵉⴳ(ⵏ)
primary: ⴰⵎⵏⵣⴰⵢ
principal: ⴰⵙⵉⵍⴰⵏ
principle: ⴰⵎⵏⵣⴰⵢ
principles: ⵉⵎⵏⵣⴰⵢⵏ
prison: ⴰⵣⵖⵓ
privacy: ⵜⵉⵏⵏⵓⵜⵍⴰ
probability: ⵜⴰⵙⵇⵇⴰⵔⵜ
problem: ⴰⵎⵓⴽⵔⵉⵙ
problems: ⵉⵎⵓⴽⵔⵉⵙⵏ
process: ⵜⵉⵣⵉⴳⵣⵜ
processed: ⵉⵜⵜⵓⵙⵎⴽⵍⵏ
processes: ⵜⵉⵣⵉⴳⵣⵉⵏ
processing: ⴰⵙⵎⴽⵍ
processor: ⴰⵙⵎⴽⴰⵍ
processors: ⵉⵙⵎⴽⴰⵍⵏ
produce: ⵜⵜⴼⴰⵔⴰⵙ
produced: ⵉⵜⵜⵓⴼⴰⵔⵙⵏ
producing: ⴰⴼⴰⵔⵙ
product: ⴰⴼⴰⵔⵉⵙ
production: ⴰⴼⴰⵔⵙ
productivity: ⴰⴳⴼⴰⵔⵉⵙ
products: ⵉⴼⴰⵔⵉⵙⵏ
professional: ⴰⵣⵣⵓⵍⴰⵏ
program: ⴰⵀⵉⵍ
programmatically: ⵙ ⵓⵙⵉⵀⵍ
programme: ⴰⵀⵉⵍ
programmed: ⵉⵜⵜⵓⵙⵉⵀⵍⵏ
programmer: ⴰⵎⵙⵉⵀⵍ
programming: ⴰⵙⵉⵀⵍ
programs: ⴰⵀⵉⵍⵏ
progress: ⴰⵏⵏⵔⵏⵉ
project: ⴰⵙⵏⴼⴰⵔ
projection: ⴰⵙⵏⵥⵕ
projects: ⵉⵙⵏⴼⴰⵔⵏ
promoting: ⴰⵙⵉⵍⵉ
promotion: ⴰⵙⵉⵍⵉ
proof: ⴰⵏⵥⴰ
proofs: ⴰⵏⵥⴰⵜⵏ
propagation: ⴰⵏⴼⵓⴼⴷ
properties: ⵜⵉⵙⴼⵍⵙⵉⵏ
property: ⵜⴰⵙⴼⵍⵙⵜ
proportionality: ⴰⵎⵢⴰⵙⴰⵖ
protein: ⴰⴼⵕⵓⵟⵉⵏ
proteins: ⵉⴼⵕⵓⵟⵉⵏⵏ
proton: ⴰⴱⵕⵓⵜⵓⵏ
protons: ⵉⴱⵕⵓⵜⵓⵏⵏ
proverb: ⴰⵏⵣⵉ
proverbs: ⵉⵏⵣⴰⵏ
provided: ⵜⵜⵓⴼⴽⴰⵏ
psychological: ⴰⵏⵉⵎⴰⵏ
psychology: ⵜⴰⵙⵏⵉⵎⴰⵏⵜ
publicity: ⴰⵙⵓⵙⵙⵏ
punctuation: ⴰⵙⵇⵉⴼⵉ
purism: ⵜⴰⵥⵕⴰⵣⴷⵉⴳⵜ
purist: ⴰⵎⵥⵕⴰⵣⴷⵉⴳ
purpose: ⴰⵙⴰⵖⴷ
pursuit: ⴰⴹⴼⴼⵓⵕ
pyramid: ⴰⵣⴰⵎⵓⴳ
pyramids: ⵉⵣⴰⵎⵓⴳⵏ
python: pⵢⵜⵀoⵏ
qualities: ⵜⵉⵖⴰⵔⵉⵡⵉⵏ
quality: ⵜⴰⵖⴰⵔⴰ
quantifiable: ⴰⵣⵎⵔⵙⴽⵜⴰⵏ
quantities: ⵜⵉⵙⵎⴽⵜⴰⵡⵉⵏ
quantity: ⵜⴰⵙⵎⴽⵜⴰ
quantum: ⵜⴰⴽⵡⴰⵏⵟⵉⵜ
queen: ⵜⴰⴳⵍⵍⵉⴷⵜ
question: ⴰⵙⵇⵙⵉ
questions: ⵉⵙⵇⵙⵉⵜⵏ
quickly: ⵙ ⵜⵎⵎⵔⵉ
quotient: ⵜⴰⵎⵏⴽⵜⴰ
radiation: ⴰⵥⵏⵥⵕ
radioactivity: ⵜⴰⵥⵏⵥⵕⵎⵓⴷⵜ
radiocarbon: ⴰⴽⴰⵕⴱⵓⵥⵏⵥⵕ
rain: ⴰⵏⵥⴰⵕ
rainbow: ⵜⴰⵙⵍⵉⵜ ⵏ ⵓⵏⵥⴰⵕ
rainbows: ⵜⵉⵙⵍⴰⵜⵉⵏ ⵏ ⵓⵏⵥⴰⵕ
raincoat: ⴰⵔⴰⵎⴰⵏ
range: ⴰⵣⵉⵍⴰⵍ
rank: ⴰⵏⵎⴰⵍⴰ
rapid: ⵉⵎⵎⵔⵉⵏ
rapidly: ⵙ ⵜⵎⵎⵔⵉ
rating: ⴰⵙⵓⵜⴳ
rational: ⴰⵖⵥⵏⴰⵏ
ray: ⴰⵥⵏⵥⴰⵕ
rays: ⵉⵥⵏⵥⴰⵕⵏ
reaction: ⵜⴰⵙⴷⵎⵉⵔⵜ
reactions: ⵜⵉⵙⴷⵎⵉⵔⵉⵏ
read: ⵖⵔ
readability: ⵜⴰⵣⵎⵔⵖⵔⵉⵜ
reader: ⵉⵎⵖⵔⵉ
real: ⴰⵏⵉⵍⴰⵡ
reality: ⵜⵉⵍⴰⵡⵜ
realization: ⴰⵙⵙⵉⵍⵉ
really: ⵏⵉⵜ
reason: ⴰⵙⵔⴰⴳ
reasonable: ⴰⵎⵏⵍⵍⵉ
reasons: ⵉⵙⵔⴰⴳⵏ
recepter: ⴰⵎⴰⵟⵟⴰⴼ
reception: ⵓⴹⵓⴼ
receptor: ⴰⵎⴰⵟⵟⴰⴼ
receptors: ⵉⵎⴰⵟⵟⴰⴼⵏ
recognition: ⴰⴽⴽⴰⵣ
recommandqtion: ⴰⵙⵖⵍⴼ
record: ⴰⴽⴰⵍⴰⵙ
records: ⵉⴽⴰⵍⴰⵙⵏ
red: ⴰⵣⴳⴳⵯⴰⵖ
reed: ⴰⵖⴰⵏⵉⵎ
refer: ⵢⴰⵖⵓⵍ
reference: ⴰⵙⴰⵖⵓⵍ
references: ⵉⵙⴰⵖⵓⵍⵏ
reflection: ⵓⵖⵓⵍ
reforming: ⴰⵙⴳⴳⴷ
refraction: ⴰⵏⵏⵔⵥ
refrigerator: ⵜⴰⵎⵙⵙⵉⵚⵎⵉⴹⵜ
region: ⵜⴰⵎⵏⴰⴹⵜ
registration: ⴰⴽⴰⵍⴰⵙ
regular: ⴰⵍⵓⴳⵏⴰⵏ
regulation: ⴰⵙⵍⵓⴳⵏ
reinforcement: ⴰⵙⵙⴷⵓⵙ
relation: ⴰⵙⵙⴰⵖ
relationship: ⵜⵓⵇⵇⵏⴰ
relationships: ⵜⵓⵇⵇⵏⵉⵡⵉⵏ
relativistic: ⴰⵏⵙⵎⵎⴰⵙⵖ
relativity: ⵜⵉⵎⵎⴰⵙⵖⵜ
religion: ⴰⵙⵖⴰⵏ
religions: ⵉⵙⵖⴰⵏⵏ
remainder: ⴰⵎⴰⴳⵓⵔ
remote: ⴰⵎⴰⴳⴳⵓⴳ
renaissance: ⵜⴰⵍⵙⵍⴰⵍⵉⵜ
repairing: ⴰⵙⴳⴳⴷ
repeatedly: ⵙ ⵡⴰⵍⵍⴰⵙ
repetitive: ⴰⵍⵍⵓⵙⴰⵏ
replites: ⵉⵎⵃⵔⵓⵔⴷⵏ
representation: ⵜⴰⴳⵏⵙⴻⵙⵜ
represented: ⵉⵜⵜⵓⴳⵏⵙⴻⵙⵏ
representing: ⴰⴳⵏⵙⴻⵙ
repression: ⴰⵎⵙⴰⵢ
reproduction: ⴰⵎⵢⴰⵔⴰⵡ
reptile: ⴰⵎⵃⵔⵓⵔⴷ
required: ⵉⵜⵜⵓⵜⵜⵔⵏ
research: ⴰⵔⵣⵣⵓ
researcher: ⴰⵎⵔⵣⵓ
researchers: ⵉⵎⵔⵣⵓⵜⵏ
researches: ⵉⵔⵣⵣⵓⵜⵏ
residents: ⵉⵎⵣⴷⴰⵖ
resistance: ⴰⵣⴱⵓ
respiration: ⴰⵙⵓⵏⴼⵙ
response: ⵜⴰⵔⴰⵔⵉⵜ
responses: ⵜⵉⵔⴰⵔⵉⵜⵉⵏ
responsible: ⴰⵎⴰⵖⵍⴰⴼ
responsive: ⴰⵎⵔⴰⵔⴰⵏ
restriction: ⴰⵙⵏⵢⵓⵎⵓ
result: ⵜⴰⵢⴰⴼⵓⵜ
results: ⵜⵉⵢⴰⴼⵓⵜⵉⵏ
retroactive: ⵉⵎⴷⵡⵍ
reusable: ⵜⴰⵍⵙⵎⵔⴰⵙⵜ
revolution: ⵜⴰⴳⵔⴰⵡⵍⴰ
reward: ⴰⵎⵔⴽⵉⴷ
rewards: ⵉⵎⵔⴽⵉⴷⵏ
rhythm: ⴰⵏⵢⴰ
rich: ⴰⵏⴱⵖⵓⵔ
richness: ⵜⴰⴱⵖⵔⵜ
riddle: ⵜⴰⵎⵙⴼⵔⵓⵜ
riddles: ⵜⵉⵎⵙⴼⵔⵓⵜⵉⵏ
right: ⴰⴼⴰⵙⵉ
rights: ⵉⵣⵔⴼⴰⵏ
risk: ⵉⵎⵉⵣⵉ
river: ⴰⵙⵉⴼ
rivers: ⵉⵙⴰⴼⴼⵏ
road: ⴰⴱⵔⵉⴷ
robot: ⴰⵕⵓⴱⵓ
robotics: ⵜⴰⵙⵏⵕⵓⴱⵓⵜ
robots: ⵉⵕⵓⴱⵓⵜⵏ
robust: ⵉⴷⵓⵙⵏ
rock: ⴰⵙⵓⵍⵉⵍ
rocket: ⴰⵙⴳⵍⵎ
rocks: ⵉⵙⵓⵍⵉⵍⵏ
role: ⵜⴰⵎⵍⵉⵍⵜ
roles: ⵜⵉⵎⵍⵉⵍⵉⵏ
roof: ⵜⴰⴷⵓⵍⵉ
roofs: ⵜⵉⴷⵓⵍⵉⵡⵉⵏ
room: ⴰⵃⴰⵏⵓ
rooms: ⵉⵃⵓⵏⴰ
root: ⴰⵥⵓⵔ
routine: ⴰⵕⵓⵜⵉⵏ
row: ⵜⴰⴷⵔⵙⵜ
rule: ⴰⵍⵓⴳⵏ
rules: ⵉⵍⵓⴳⴰⵏ
sadness: ⴰⵖⵉⵍⵓⴼ
salary: ⵜⵉⵖⵔⴰⴷ
salt: ⵜⵉⵙⵏⵜ
sample: ⵜⵓⴽⴽⵉⵙⵜ
sand: ⴰⵎⵍⴰⵍ
sarcomere: ⴰⵙⴰⵔⴽⵓⵎⵉⵔ
satellite: ⴰⴳⵏⵙⴰ
saturday: ⴰⵙⵉⴹⵢⴰⵙ
saturn: ⴰⵡⵉⵀⴰⴷ
scalable: ⴰⵎⵙⴽⴰⵍ
scale: ⵜⴰⵙⴽⴰⵍⴰ
scalpel: ⴰⵙⴼⵍⵉ
scanner: ⴰⵎⵖⵔⵉ
scenario: ⴰⵙⵉⵏⴰⵔⵢⵓ
scenarios: ⵉⵙⵉⵏⴰⵔⵢⵓⵜⵏ
scene: ⴰⵙⴰⵢⵙ
school: ⵜⵉⵏⵎⵍ
schools: ⵜⵉⵏⵎⴰⵍ
science: ⵜⵓⵙⵙⵏⴰ
sciences: ⵜⵓⵙⵙⵏⵉⵡⵉⵏ
scientific: ⵓⵙⵙⵏⴰⵏ
scientist: ⴰⵎⴰⵙⵙⴰⵏ
scientists: ⵉⵎⴰⵙⵙⴰⵏⵏ
scope: ⴰⵣⵉⵍⴰⵍ
scorpion: ⵉⵖⵉⵔⴷⵎ
screen: ⴰⴳⴷⵉⵍ
screens: ⴰⴳⴷⵉⵍⵏ
script: ⵜⵉⵔⴰⵔⵜ
sea: ⵉⵍⵍ
seas: ⵉⵍⵍⵏ
season: ⵉⵎⵉⵔ
seasons: ⵉⵎⵉⵔⵏ
second: ⵡⵉⵙⵙ ⵙⵉⵏ
secret: ⵓⴼⴼⵉⵔ
secrets: ⵓⴼⴼⵉⵔⵏ
section: ⴰⴳⵎⵎⵓⵏ
sections: ⵉⴳⵎⵎⵓⵏⵏ
sector: ⵜⴰⴳⵎⵎⵓⵏⵜ
security: ⵜⴰⵖⵍⵙⵜ
securities: ⵜⴰⵖⵍⵍⵉⵙⵉⵏ
self-awareness: ⵜⴰⴼⵔⴽⵉⵎⴰⵏⵜ
semantic: ⴰⵏⴰⵎⴽⴰⵏ
semantics: ⵜⴰⵙⵏⴰⵏⴰⵎⴽⵜ
semi-autonomous: ⴰⵣⵏⵙⵉⵎⴰⵏ
semicolon: ⵜⵉⵙⴽⵔⵇⵉⴼⵉⵜ
semiotic: ⵜⴰⵙⵏⴰⵎⴽⴰ
semolina: ⴰⵡⵔⵏ
sender: ⴰⵎⵙⵙⵉⴼⴹ
sense: ⵜⴰⵙⴼⵔⴽⵜ
sensing: ⵜⵉⴼⴼⵓⵔⴽⴰ
sensitivity: ⵜⵉⴼⴼⵓⵔⴽⴰ
sensory: ⴰⴼⵔⵢⴰⵏ
sentence: ⵜⴰⵡⵉⵏⵙⵜ
sentences: ⵜⵉⵡⵉⵏⴰⵙ
sequence: ⵜⴰⴳⵣⵣⵓⵎⵜ
sequence: ⵜⴰⵏⴳⵣⵓⵎⵜ
sequence: ⵜⴰⵏⴳⵣⵓⵎⵜ
sequences: ⵜⵉⵏⴳⵣⵓⵎⵉⵏ
sequential: ⴰⵏⵓⴳⵣⵉⵎ
series: ⵉⵙⴷⴷⵉⵜⵏ
service: ⵜⴰⵏⴰⴼⵓⵜ
services: ⵜⵉⵏⵓⴼⴰ
set: ⵜⴰⴳⵔⵓⵎⵎⴰ
setting: ⵜⴰⵙⵖⵍⵜ
settings: ⵜⵉⵙⵖⴰⵍ
several: ⵜⵓⴳⵜ
sex: ⴰⴳⵏⵓⵙ
shadow: ⴰⵎⴰⵍⵓ
shape: ⵜⴰⵡⵉⵍⴰ
shapes: ⵜⵉⵡⵉⵍⴰⵡⵉⵏ
share: ⴷⵔⵓ
shared: ⵉⵜⵜⵓⴷⵔⴰⵏ
she: ⵏⵜⵜⴰⵜ
sheep: ⴰⴽⵔⴰⵔ
sheet: ⵜⵉⴼⵔⵜ
sheets: ⵜⵉⴼⵔⵜⵉⵏ
shepherd: ⴰⵎⴽⵙⴰ
shepherd: ⴰⵎⴽⵙⴰ
shepherds: ⵉⵎⴽⵙⴰⵡⵏ
ship: ⴰⵖⵔⵔⴰⴱⵓ
shirt: ⵜⴰⴷⴼⴼⴰⵙⵜ
shoe: ⴰⵔⴽⴰⵙ
short: ⴰⴳⵣⵍⴰⵏ
shooting star: ⵜⴰⵣⵔⴰⵢⵢⴰⵜ
should: ⵢⵓⵛⵛⵍ
shrine: ⴰⵥⴽⴽⴰ
shrub: ⴰⵙⵙⵉ
sickle: ⴰⵎⴳⵔ
side: ⵜⴰⵙⴳⴰ
sides: ⵜⴰⵙⴳⵉⵡⵉⵏ
sight: ⵉⵥⵕⵉ
signal: ⵜⴰⵎⴰⵜⴰⵔⵜ
signals: ⵜⵉⵎⴰⵜⴰⵔⵉⵏ
silently: ⵙ ⵢⵉⴼⵙⵜⵉ
silver: ⴰⵥⵕⴼ
similar: ⵉⵔⵡⴰⵙⵏ
simple: ⴰⴼⵔⴰⵔ
simplicity: ⵜⵉⵏⵀⵍⵉ
simplified: ⵉⵜⵜⵓⵙⴼⵔⴻⵔⵏ
simply: ⵙ ⵜⴼⵔⴰⵔⵓⵜ
since: ⵙⴳ
single: ⴰⵙⵓⴼ
singularity: ⵜⴰⵙⵓⴼⴰ
sister: ⵉⵙⵜⵎⴰ
sister: ⵓⵍⵜⵎⴰ
site: ⴰⵏⵙⴰ
situation: ⴰⵙⵓⵔⵙ
situations: ⵉⵙⵓⵔⴰⵙ
seven: ⵙⴰ
seventy: ⵙⴰⵎⵔⴰⵡ
sight: ⵉⵥⵕⵉ
sign: ⵜⴰⵎⴰⵜⴰⵔⵜ
six: ⵚⴹⵉⵚ
sixty: ⵙⴹⵉⵎⵔⴰⵡ
size: ⵜⵉⴷⴷⵉ
sizes: ⵜⵉⴷⴷⵉⵡⵉⵏ
skeleton: ⵜⴰⵖⵙⵙⴰ
skill: ⴰⴼⵓⴽⴽⵙ
skills: ⵉⴼⵓⴽⴽⵙⵏ
skin: ⵉⵍⵎ
skins: ⵉⵍⵎⴰⵡⵏ
skirt: ⵜⴰⵙⴰⴼⴰ
skull: ⴰⵇⵍⵇⵓⵍ
sky: ⵉⴳⵏⵏⴰ
small: ⴰⵎⵥⵢⴰⵏ
smaller: ⴰⵎⵥⵢⴰⵏ
smallest: ⴰⴽⴽⵯ ⵉⴳⴰⵏ ⴰⵎⵥⵢⴰⵏ
smart: ⴰⵎⵉⵖⵉⵙ
smartphone: ⴰⵜⵉⵍⵉⴼⵓⵏ ⴰⵎⵉⵖⵉⵙ
snake: ⵉⴼⵉⵖⵔ
social: ⴰⵏⴰⵎⵓⵏ
society: ⴰⵎⵓⵏ
societies: ⵉⵎⵓⵏⵏ
software: ⴰⵙⵖⵥⴰⵏ
soil: ⴰⴽⴰⵍ
solar: ⴰⴼⵓⴽⴰⵏ
solid: ⵓⵏⵜⵉⵎ
solved: ⵉⵜⵜⵓⴼⵙⴰⵢⵏ
some: ⴽⵔⴰ
someone: ⴽⵔⴰ ⵏ ⵢⴰⵏ
something: ⴽⵔⴰ ⵏ ⵜⵖⴰⵡⵙⴰ
sometimes: ⴽⵔⴰ ⵏ ⵜⴽⴽⴰⵍ
soon: ⵢⴰⵥ
sophistication: ⵜⴰⵏⴼⵍⵉⵜ
sound: ⵉⵎⵙⵍⵉ
sounds: ⵉⵎⵙⵍⵉⵜⵏ
source: ⴰⵖⴱⴰⵍⵓ
sources: ⵉⵖⴱⴰⵍⵓⵜⵏ
sourmilk: ⵉⵖⵉ
south: ⴰⵏⵥⵓⵍ
space: ⴰⵙⴰⵢⵔⴰⵔ
spaces: ⵉⵙⴰⵢⵔⴰⵔⵏ
spacetime: ⴰⵙⴰⵢⵔⴰⵔⴽⵓⴷ
special: ⵉⵥⵍⵉⵏ
speciality: ⵜⴰⵥⵍⴰⵢⵜ
species: ⴰⵏⴰⵡⵏ
specific: ⴰⵏⵥⵍⴰⵢ
spectrum: ⴰⵣⵔⴰⵔⴰⴳ
speech: ⴰⵡⴰⵍ
speed: ⵜⵉⵎⵎⵔⵉ
sphere: ⵜⴰⵡⵊⵊⴰ
spider: ⵜⴰⴱⵖⴰⵢⵏⵓⵙⵜ
spike: ⴰⵙⵏⵏⴰⵏ
spoon: ⵜⴰⵖⵏⵊⴰⵡⵜ
spoons: ⵜⵉⵖⵏⵊⴰⵡⵉⵏ
sport: ⵜⵓⵏⵏⵓⵏⵜ
sports: ⵜⵓⵏⵏⵓⵏⵉⵏ
spring: ⵜⴰⴼⵙⵓⵜ
square: ⴰⵎⴽⴽⵓⵥ
squares: ⵉⵎⴽⴽⵓⵥⵏ
stability: ⵜⵉⵣⴳⵉ
stable: ⵉⵎⵣⴳⵉ
stadium: ⴰⵙⵓⵔⴰⵔ
stage: ⵜⴰⴷⴰⵍⴰ
stages: ⵜⵉⴷⴰⵍⵉⵡⵉⵏ
star: ⵉⵜⵔⵉ
stars: ⵉⵜⵔⴰⵏ
station: ⴰⵙⵔⵙ
state: ⴰⴷⴷⴰⴷ
statement: ⵜⴰⵏⵎⵎⴰⵍⵜ
statements: ⵜⴰⵏⵎⵎⴰⵍⵉⵏ
states: ⴰⴷⴷⴰⴷⵏ
statistical: ⴰⵙⵏⴰⴷⴷⴰⴷⴰⵏ
statistics: ⵜⴰⵙⵏⴰⴷⴷⴰⴷⵜ
status: ⴰⴷⴷⴰⴷ
stellar: ⴰⵜⵔⴰⵢⴰⵏ
step-by-step: ⵜⴰⵙⵓⵔⵉⴼⵜ ⵙ ⵜⵙⵓⵔⵉⴼⵜ
step: ⵜⴰⵙⵓⵔⵉⴼⵜ
steps: ⵜⵉⵙⵓⵔⵉⴼⵉⵏ
still: ⵉⵙⵓⵍ
stimulation: ⴰⵏⵣⴰⵍ
stimulations: ⴰⵏⵣⴰⵍⵏ
stimuli: ⵉⵎⵏⵣⴰⵍⵏ
stomach: ⵜⴰⴷⵉⵙⵜ
stone: ⴰⵥⵕⵓ
stones: ⵉⵥⵕⴰⵏ
store: ⵜⴰⵃⴰⵏⵓⵜ
storm: ⵜⴰⵎⵊⵉⵡⵛⵜ
story: ⵜⵓⵍⵍⵉⵙⵜ
straight: ⴰⵎⴰⵖⵓⴷ
strategies: ⵜⵉⵙⵜⵔⴰⵜⵉⵊⵉⵢⵉⵏ
strategy: ⵜⴰⵙⵜⵔⴰⵜⵉⵊⵉⵜ
stratigraphy: ⵜⴰⵙⴽⵏⵙⵡⵔⵜ
strength: ⴰⴷⵡⴰⵙ
stress: ⴰⴽⵕⴰⵥ
string: ⴰⵣⵔⴰⵔ
strings: ⵉⵣⵔⴰⵔⵏ
strong: ⵉⴷⵓⵙⵏ
stronger: ⴰⵎⴷⵓⵙ
stronger: ⴰⵎⴷⵓⵙ
structure: ⵜⵓⵥⴽⵉⵡⵜ
structures: ⵜⵓⵥⴽⵉⵡⵉⵏ
student: ⴰⵏⵍⵎⴰⴷ
students: ⵉⵏⵍⵎⴰⴷⵏ
studies: ⵜⵉⵣⵔⴰⵡⵉⵏ
study: ⵜⴰⵣⵔⴰⵡⵜ
subatomic: ⴰⴷⵓⴱⵍⴽⴰⵎ
subfamily: ⵜⴰⴷⵓⵡⵊⴰ
subject(gram.): ⴰⵎⴳⴳⴰⵢ
submicroscopic: ⴰⴷⵓⵎⵥⵉⵥⵕⴰⵢ
subset: ⵜⴰⴷⵓⴳⵔⵓⵎⵎⴰ
subsets: ⵜⵉⴷⵓⴳⵔⵓⵎⵎⴰⵡⵉⵏ
substitution: ⵜⵉⴽⵙⵔⴻⵔⵜ
subtitle: ⴰⴷⵓⵣⵡⵍ
subtitles: ⵉⴷⵓⵣⵡⴰⵍ
subtraction: ⵜⵓⴽⴽⵙⴰ
success: ⴰⵎⵓⵔⵙ
successes: ⵉⵎⵓⵔⵙⵏ
successful: ⵉⵎⵓⵔⵙⵏ
successfully: ⵙ ⵓⵎⵓⵔⵙ
such: ⵣⵓⵏ ⴷ
sufficient: ⴰⵎⵓⴷⵉ
sugar: ⴰⵙⴽⴽⵯⴰⵔ
suit: ⵜⵉⴽⴱⵔⵜ
sum: ⵜⴰⵎⵔⵏⵉⵡⵜ
summer: ⴰⵏⴱⴷⵓ
sun: ⵜⴰⴼⵓⴽⵜ
sunday: ⴰⵙⴰⵎⴰⵙ
sunlight: ⵜⵉⴼⴰⵡⵜ ⵏ ⵜⴰⴼⵓⴽⵜ
sunrise: ⴰⵏⵇⵇⵔ ⵏ ⵜⴰⴼⵓⴽⵜ
sunset: ⴰⵖⵍⵍⵓⵢ ⵏ ⵜⴰⴼⵓⴽⵜ
supercluster: ⵜⴰⴱⵔⵥⵕⵎⵜ
superclusters: ⵜⵉⴱⵔⵥⵕⵎⵉⵏ
supernova: ⴰⴱⵔⵎⵙⵙⵉ
superpower: ⵜⴰⴱⵔⵣⵎⵔⵜ
superpowers: ⵜⵉⴱⵔⵣⵎⴰⵔ
sure: ⵉⵍⴽⵏ
surface: ⵜⴰⵊⵓⵎⵎⴰ
surgery: ⵜⴰⵎⵀⵍⵜ ⵜⴰⵏⴼⵍⴰⵢⵜ
surgical: ⴰⵏⴼⵍⴰⵢ
surprise: ⵜⵓⵥⵡⴰⵢⵜ
surprises: ⵜⵓⵥⵡⴰⵢⵉⵏ
surveillance: ⴰⵎⵓⵜⵔ
survival: ⴰⴼⵓⴷⵔ
suspension: ⴰⴳⴰⵍ
swamp: ⴰⵍⵎⴰ
sweat: ⵜⵉⴷⵉ
sweater: ⴰⴷⵍⴰⵡ
sweatshirt: ⴰⵔⵚⵎⵉⴹ
sweet: ⴰⵥⵉⴷⴰⵏ
sword: ⴰⴳⵙⵜⵓⵔ
symbol: ⵉⵏⵉⴳⵍ
symbols: ⵉⵏⴰⴳⵍⵉⵡⵏ
symptom: ⴰⵙⴽⵏ
symptoms: ⵉⵙⴽⵏⴰ
synchronising: ⴰⵎⵢⴰⴽⵓⴷ
syndrome: ⴰⴳⵜⵎⵉⵜⴰⵔ
syndromes: ⵉⴷ ⵡⴰⴳⵜⵎⵉⵜⴰⵔ
synecdoche: ⵜⴰⴷⴳⵜⴰ
synonym: ⴰⴽⵏⵉⵡ
syntactic: ⴰⵙⴷⴷⴰⵙⴰⵏ
syntagm: ⵓⴷⴷⵓⵙ
syntax: ⵜⴰⵙⴷⴷⴰⵙⵜ
system: ⴰⵏⴳⵔⴰⵡ
systematic: ⴰⵏⴳⵔⴰⵡⴰⵏ
systems: ⵉⵏⴳⵔⴰⵡⵏ
tab: ⴰⵙⴽⵙⵍ
table: ⵜⴰⴼⵍⵡⵉⵜ
tablet: ⵜⵉⴼⵉⵍⵜ
taboo: ⵜⴰⴳⴷⵍⵜ
tabs: ⵉⵙⴽⵙⴰⵍ
tale: ⵜⴰⵏⴼⵓⵙⵜ
talent: ⵜⵉⵏⴼⴽⵉⵜ
talents: ⵜⵉⵏⴼⴽⴰ
tales: ⵜⵉⵏⴼⵓⵙⵉⵏ
tall: ⵓⵖⵣⵉⴼ
task: ⵜⴰⵖⵍⵉⴼⵜ
tasks: ⵜⵉⵖⵍⵉⴼⵉⵏ
teacher: ⴰⵙⵍⵎⴰⴷ
teachers: ⵉⵙⵍⵎⴰⴷⵏ
teaching: ⴰⵙⵍⵎⴷ
team: ⵜⴰⵔⴰⴱⴱⵓⵜ
teams: ⵜⵉⵔⴰⴱⴱⵓⵜⵉⵏ
tears: ⵉⵎⵟⵟⴰⵡⵏ
technical: ⴰⵜⵡⵉⵍⴰⵏ
technological: ⴰⵙⵏⵜⵡⵉⵍⴰⵏ
technologies: ⵜⵉⵙⵏⵜⵡⵉⵍⵉⵏ
technology: ⵜⴰⵙⵏⵜⵡⵉⵍⵜ
t-shirt: ⴰⵔⵉⴽⵉ
teeth: ⵜⵓⵖⵎⴰⵙ
ten: ⵎⵔⴰⵡ
telescope: ⴰⵜⵉⵍⵉⵙⴽⵓⴱ
telescopes: ⵉⵜⵉⵍⵉⵙⴽⵓⴱⵏ
television: ⵜⵉⵍⵉⵥⵕⵉ
temperature: ⴰⵣⵖⴰⵍ
templating: ⴰⵙⵎⵓⴷⵎ
ten: ⵎⵔⴰⵡ
tens: ⵜⵉⵎⵔⴰⵡⵉⵏ
tent: ⵜⴰⴳⵉⵟⵓⵏⵜ
tenths: ⵉⴼⵎⵔⴰⵡⵏ
term: ⵉⵔⵎ
terminal: ⴰⵙⵎⴷⴰⵏ
terms: ⵉⵔⵎⴰⵡⵏ
text: ⴰⴹⵕⵉⵚ
texts: ⵉⴹⵕⵉⵚⵏ
than: ⵖⴼ
thanks: ⵜⴰⵏⵎⵎⵉⵔⵜ
the practice: ⵜⵉⵍⵉⵍⵜ
their: ⵏⵏⵙⵏ
theirs: ⵡⵉⵏⵏⵙⵏ
themselves: ⵉⵖⴼⴰⵡⵏ ⵏⵏⵙⵏ
then: ⵉⵍⵎⵎⴰ
theorem: ⴰⵙⴽⴽⵓⴷ
theories: ⵜⵉⵥⵕⵉⵡⵉⵏ
theorist: ⴰⵎⵥⵕⴰⵢ
theoritical: ⴰⵥⵕⴰⵢⴰⵏ
theorizing: ⴰⵙⵥⵕⵉ
theory: ⵜⵉⵥⵕⵉ
there: ⵖⵉⵏⵏ
therefore: ⵉⵍⵎⵎⴰ
thermodynamics: ⵜⴰⵣⵖⵍⵎⵓⵙⵙⵓⵜ
these: ⵡⵉⴷ
they: ⵏⵜⵜⵏⵉ
thick: ⴰⵣⵓⵔⴰⵏ
thigh: ⵜⴰⵖⵎⴰ
thin: ⵓⵙⴷⴰⴷ
thing: ⵜⴰⵖⴰⵡⵙⴰ
things: ⵜⵉⵖⴰⵡⵙⵉⵡⵉⵏ
thinking: ⴰⵙⵡⵉⵏⴳⵎ
third: ⵡⵉⵙⵙ ⴽⵕⴰⴹ
thirty: ⴽⵕⴰⵎⵔⴰⵡ
thorn: ⴰⵙⵏⵏⴰⵏ
thought: ⵜⵉⴷⵎⵉ
thoughts: ⵜⵉⴷⵎⵉⵡⵉⵏ
thousand: ⵉⴼⴹⵏ
thousandths: ⵉⴼⵉⴼⴹⵏ
three: ⴽⵕⴰⴹ
through: ⵖⵔ
thumbs: ⵉⴽⵎⵣ
thunder: ⵉⴳⴳⵉⴳ
thursday: ⴰⴽⵡⴰⵙ
time: ⴰⴽⵓⴷ
timeframe: ⴰⵙⴰⵜⵉ ⵏ ⵡⴰⴽⵓⴷ
timeline: ⴰⵣⵔⵉⴳ ⵏ ⵡⴰⴽⵓⴷ
timelines: ⵉⵣⵔⵉⴳⵏ ⵏ ⵡⴰⴽⵓⴷ
times: ⴰⴽⵓⴷⵏ
tissue: ⵜⵓⵥⴹⵉⴹⵜ
tissues: ⵜⵓⵥⴹⵉⴹⵉⵏ
title: ⴰⵣⵡⵍ
today: ⴰⵙⵙ ⴰⴷ
toe: ⵜⵉⴼⴷⵏⵜ
toenail: ⵉⵙⴽⵔ
together: ⵉⵏⴳⵔⴰⵜⵏⵖ
tomb: ⴰⵥⴽⴽⴰ
tomorrow: ⴰⵣⴽⴽⴰ
tongue: ⵉⵍⵙ
tongues: ⴰⵍⵙⵉⵡⵏ
tonight: ⵉⴹ ⴰⴷ
tool: ⵉⵎⵉⵙⵙ
tools: ⵉⵎⴰⵙⵙⵏ
tooth: ⵜⵓⵖⵎⵙⵜ
top: ⴰⴼⵍⵍⴰ
topic: ⵉⵎⵔⵙⵉ
topics: ⵉⵎⵔⵙⴰⵏ
tortoise: ⵉⴼⴽⵔ
total: ⴰⵖⵔⵓⴷ
totally: ⵏⵉⵜ
tourism: ⵜⴰⵎⴰⵍⵍⴰⵢⵜ
tourist: ⴰⵎⵍⴰⵍⵍⴰⵢ
toy: ⵜⴰⵙⵓⵔⴰⵔⵜ
toys: ⵜⵉⵙⵓⵔⴰⵔⵉⵏ
trade: ⵜⴰⵙⵜⴰⴳⵜ
tradition: ⵜⴰⵡⵔⴳⵍⴰⵜ
traditions: ⵜⵉⵡⵔⴳⵍⴰⵜⵉⵏ
training: ⴰⵙⵍⵓⵖⵎⵓ
trajectory: ⴰⵙⴰⴽⴰ
transcription: ⴰⵙⴻⵙⴽⵍ
transformation: ⵜⴰⵏⴼⵍⴰⵍⵖⴰ
transformations: ⵜⵉⵏⴼⵍⴰⵍⵖⵉⵡⵉⵏ
translation: ⴰⵙⵓⵖⵍ
translations: ⵜⵉⵙⵓⵖⴰⵍ
translator: ⴰⵎⵙⵓⵖⵍ
translators: ⵉⵎⵙⵓⵖⵍⵏ
transmission: ⴰⵙⵎⵓⵜⵜⵉ
transmissions: ⵉⵙⵎⵓⵜⵜⵉⵢⵏ
treatment: ⴰⵙⵎⴽⵍ
treatments: ⵉⵙⵎⴽⴰⵍ
tree: ⵜⴰⴷⴷⴰⴳⵜ
trees: ⵜⴰⴷⴷⴰⴳⵉⵏ
triangle: ⴰⵎⴽⵕⴰⴹ
triangles: ⵉⵎⴽⵕⴰⴹⵏ
trigonometry: ⵜⴰⴽⵕⴷⵉⵙⴰⴽⵜ
triphosphate: ⴰⴽⵕⴼⵓⵙⴼⴰⵟ
true: ⵉⴷⴷⵜ
truth: ⵜⵉⴷⵜ
truths: ⵜⵉⴷⵜⵉⵏ
tumor: ⵜⴰⴼⴰⴼⵜ
tumors: ⵜⵉⴼⴰⴼⵉⵏ
turtle: ⵉⴼⴽⵔ
tuesday: ⴰⵙⵉⵏⴰⵙ
two: ⵙⵉⵏ
twenty: ⵙⵎⵔⴰⵡ
type: ⴰⵏⴰⵡ
types: ⴰⵏⴰⵡⵏ
under: ⴷⴷⴰⵡ
underlying: ⵜⵜⵓⵎⴰⵏ
understanding: ⴰⵔⵎⴰⵙ
understood: ⵜⵜⵓⵔⵎⴰⵙ
unexpected: ⴰⵔⵓⴹⴽⵉⴹ
union: ⵜⴰⵎⵓⵏⵜ
unique: ⴰⵎⵢⵉⵡⵏ
unit: ⵜⴰⵢⵓⵏⵜ
unities: ⵜⵉⵢⵓⵏⵉⵏ
units: ⵜⵉⵢⵓⵏⵉⵏ
unity: ⵜⴰⵢⵓⵏⵜ
universal: ⴰⵎⵖⵔⴰⴷⴰⵏ
universe: ⴰⵎⵖⵔⴰⴷ
universes: ⵉⵎⵖⵔⴰⴷⵏ
university: ⵜⴰⵙⴷⴰⵡⵉⵜ
unknown: ⴰⵔⵓⵙⵙⵉⵏ
until: ⴰⵔⴷ
update: ⴰⵙⴷⵖⵉ
till: ⴰⵔ/ⴰⵔⴷ
uranus: ⵓⵕⴰⵏⵓⵙ
usage: ⴰⵙⵙⵎⵔⵙ
used: ⵉⵜⵜⵓⵙⵙⵎⵔⴰⵙⵏ
useful: ⵓⵎⵔⵉⵙ
useless: ⴰⵔⵓⵎⵔⵉⵙ
user: ⴰⵙⵎⵔⴰⵙ
using: ⵙ ⵓⵙⵙⵎⵔⵙ
vagina: ⵉⴱⵛⵛⵉ
validity: ⵜⵉⵏⵏⵣⴳⵉⵜ
valley: ⴰⵖⵣⵔ
valuable: ⴰⵎⵙⵙⴰⵣⴰⵍ
value: ⴰⵣⴰⵍ
values: ⴰⵣⴰⵍⵏ
variable: ⴰⵎⵙⴽⵉⵍ
variables: ⵉⵎⵙⴽⵉⵍⵏ
variation: ⴰⵎⵎⵙⴽⵍ
variety: ⵜⴰⵎⵣⴰⵔⴰⵢⵜ
various: ⵎⵏⵏⴰⵡ
vast: ⴰⵎⵉⵔⵉⵡ
vector: ⴰⵎⴰⵡⴰⵢ
vectors: ⵉⵎⴰⵡⴰⵢⵏ
velocity: ⵜⵉⵎⵎⵔⵉ
venus: ⴰⵎⴰⴹⴰⵏ
verification: ⴰⵙⵙⵉⴷⵜ
versability: ⵜⴰⴳⵜⵣⴰⵍⴰ
versatile: ⴰⵙⵎⵜⵜⴰⵢ
version: ⵜⵓⵏⵖⵉⵍⵜ
versions: ⵜⵓⵏⵖⵉⵍⵉⵏ
very: ⴱⴰⵀⵔⴰ
vibration: ⴰⵏⴷⵓⴷⵉ
vibrations: ⵉⵏⴷⵓⴷⵉⵢⵏ
vehicle: ⵜⴰⵎⵙⵙⵓⴷⵓⵜ
video: ⴰⴼⵉⴷⵢⵓ
videos: ⵉⴼⵉⴷⵢⵓⵜⵏ
village: ⴰⵙⵓⵏ
viper: ⵜⴰⵍⴰⴼⵙⴰ
virus: ⴰⵏⴼⴰⴼⴰⴷ
vision: ⴰⵙⴽⵙⵓ
visual: ⴰⵎⵥⵕⴰⵡ
visualization: ⵜⴰⵎⵓⵖⵍⵉ
vocabulary: ⵜⴰⵏⵙⵉⵡⴰⵍⵜ
voice: ⵉⵎⵙⵍⵉ
void: ⵜⵓⴳⴰⵡⵜ
voids: ⵜⵓⴳⴰⵡⵉⵏ
wall: ⴰⵖⵔⴰⴱ
walls: ⵉⵖⵔⴱⴰⵏ
war: ⵉⵎⵏⵖⵉ
wardrobe: ⵜⴰⴽⴰⴼⵓⵜ
wardrobes: ⵜⵉⴽⴰⴼⵓⵜⵉⵏ
warm: ⵢⵓⵍⴱⴰⵏ
wasp: ⴰⵔⵥⴰⵥ
water: ⴰⵎⴰⵏ
waterfall: ⴰⵎⴰⵣⵣⵔ
wave: ⵜⴰⵢⵢⵓⵖⵜ
wavelength: ⵜⵉⵖⵣⵉ ⵏ ⵜⵢⵢⵓⵖⵜ
wavelengths: ⵜⵉⵖⵣⵉⵡⵉⵏ ⵏ ⵜⵢⵢⵓⵖⵉⵏ
waves: ⵜⵉⵢⵢⵓⵖⵉⵏ
way: ⵜⴰⵖⴰⵔⴰⵙⵜ
ways: ⵜⵉⵖⴰⵔⴰⵙⵉⵏ
we: ⵏⴽⴽⵯⵏⵉ
weakness: ⴰⵍⵎⴰⴹ
weast: ⴰⵜⴰⵔⴰⵎ
weather: ⴰⵏⵣⵡⵉ
website: ⴰⵏⵙⴰ
wednesday: ⴰⴽⵕⴰⵙ
week: ⵉⵎⴰⵍⴰⵙⵙ
weekend: ⵜⵉⴳⵉⵔⴰ ⵏ ⵉⵎⴰⵍⴰⵙⵙ
weeks: ⵉⵎⴰⵍⴰⵙⵙⵏ
weight: ⵜⴰⵥⴰⵢⵜ
welcome: ⴰⵏⵙⵓⴼ
well: ⴰⵏⵓ
wet: ⵉⴱⵣⴳ
wheat: ⵉⵔⴷⵏ
wheel: ⵜⴰⵙⵖⴰⵍⵜ
whether: ⵙⵡⴰ
white: ⵓⵎⵍⵉⵍ
whole: ⵉⵎⴷⵏ
wide: ⴰⵎⵉⵔⵉⵡ
widely: ⵙ ⵜⵉⵔⵉⵡⵜ
wife: ⵜⴰⵎⵟⵟⵓⵜ
wildboar: ⵉⵍⴼ
wind: ⴰⴹⵓ
window: ⵜⴰⵙⵕⵥⵎⵜ
Windows: ⵡⵉⵏⴷⴰⵡⵣ
windows: ⵜⵉⵙⵕⵥⵎⵉⵏ
wing: ⵉⴼⵔ
winter: ⵜⴰⴳⵔⵙⵜ
wisdom: ⵜⵉⵏⵥⴻⵥⵜ
wise: ⵓⵏⵥⵉⵥ
with: ⴷ
within: ⵉⵍⵍⴰⵏ ⴳ
without: ⵎⵉⵏ
woman: ⵜⴰⵎⵟⵟⵓⵜ
women: ⵜⵉⵎⵟⵟⵓⵜⵉⵏ
wood: ⴰⵙⵖⴰⵔ
wool: ⵜⴰⴹⵓⴼⵜ
word: ⵜⴰⴳⵓⵔⵉ
words: ⵜⵉⴳⵓⵔⵉⵡⵉⵏ
work: ⵜⴰⵡⵓⵔⵉ
world: ⴰⵎⴰⴹⴰⵍ
worlds: ⵉⵎⴰⴹⴰⵍⵏ
worldwide: ⴰⵎⴰⴹⵍⴰⵏ
worm: ⵜⴰⵡⴽⴽⴰ
worry: ⴰⵏⵣⴳⵓⵎ
wrong: ⴰⵣⴳⴰⵍ
year: ⴰⵙⴳⴳⵯⴰⵙ
years: ⵉⵙⴳⴳⵯⴰⵙⵏ
yeast: ⵜⴰⵎⵜⵓⵏⵜ
yellow: ⴰⵡⵔⴰⵖ
yes: ⵢⴰⵀ
yesterday: ⴰⵙⵙⵏⴰⵟ
you: ⴽⵢⵢⵉ
young: ⴰⵎⵥⵢⴰⵏ
your: ⵏⵏⴽ
yours: ⵡⵉⵏⵏⴽ
yourself: ⵉⵖⴼ ⵏⵏⴽ
zone: ⴰⴷⵖⴰⵔ
zones: ⵉⴷⵖⴰⵔⵏ








